date,state_code,total_tests,new_tests,total_cases,new_cases,total_negatives,new_negatives,total_deaths,new_deaths,total_hospitalized,currently_hospitalized,new_hospitalized,in_icu_currently,in_icu_cumulative,on_ventilator_currently,on_ventilator_cumulative,recovered,data_quality_grade
20200719,AK,173010,4647,2277,118,170733,4529,18,0,,27,0,,,1,,712,A
20200719,AL,585533,11038,67011,1777,518522,9261,1287,1,7782,920,0,,988,,526,29736,B
20200719,AR,419171,6166,32533,771,386638,5395,357,4,2177,453,42,,,97,307,25292,A+
20200719,AZ,785979,13988,143624,2359,642355,11629,2761,31,6632,3136,65,894,,622,,18149,A+
20200719,CA,6286852,119634,384692,9329,5902160,110305,7685,90,,8398,0,2107,,,,,B
20200719,CO,435938,5155,39788,444,396150,4711,1615,0,6019,401,25,,,,,4948,A
20200719,CT,629969,0,47893,0,582076,0,4396,0,10654,66,0,,,,,8466,B
20200719,DC,147765,2810,11261,67,136504,2743,578,0,,91,0,17,,12,,1886,A+
20200719,DE,152995,2238,13519,90,139476,2148,523,0,,47,0,9,,,,7362,A+
20200719,FL,3002641,70653,350047,12478,2652594,58175,5091,89,21309,9363,340,,,,,,A
20200719,GA,1255319,23513,143123,3251,1112196,20262,3173,5,15010,3036,49,,2822,,,,A
20200719,GU,18253,0,315,0,17938,0,5,0,,4,0,,,,,222,B
20200719,HI,104635,1640,1354,20,103281,1620,24,1,140,,1,,,,,1019,D
20200719,IA,415491,11762,38723,816,376768,10946,794,7,,214,0,75,,31,,27894,A+
20200719,ID,146186,3681,14302,550,131884,3131,119,1,583,224,13,33,180,,,3989,A
20200719,IL,2245686,32113,162750,965,2082936,31148,7488,5,,1356,0,320,,132,,,A
20200719,IN,626880,12425,56571,917,570309,11508,2822,2,7895,786,34,244,1675,81,,40965,A+
20200719,KS,249353,0,21965,0,227388,0,299,0,1453,,0,58,427,14,161,983,A
20200719,KY,490201,0,22184,0,468017,0,667,0,2875,514,0,109,1033,,,6824,B
20200719,LA,1069304,25364,91706,3116,977598,22248,3543,34,,1469,0,,,177,,53288,B
20200719,MA,1040535,13702,113534,296,927001,13406,8431,12,11717,498,8,64,,41,,95390,A+
20200719,MD,739785,18799,78131,925,661654,17874,3377,9,11841,449,53,131,,,,5344,A
20200719,ME,137437,2508,3687,41,133750,2467,117,0,375,10,0,9,,7,,3148,A+
20200719,MI,1484459,28381,81868,530,1402591,27851,6366,2,,680,0,201,,102,,55162,A+
20200719,MN,853188,17226,46204,734,806984,16492,1581,3,4627,258,25,120,1389,,,40001,A
20200719,MO,559079,8203,33094,846,525985,7357,1129,-1,,875,0,,,86,,,B
20200719,MP,10701,0,37,0,10664,0,2,0,4,,0,,,,,29,D
20200719,MS,378077,792,42638,792,335439,0,1355,9,3727,1129,0,278,,132,,25932,A
20200719,MT,133159,1280,2533,62,130626,1218,37,0,165,47,1,,,,,1075,C
20200719,NC,1394864,15721,99778,1820,1295086,13901,1634,5,,1115,0,,,,,67124,A
20200719,ND,133854,2339,5019,112,128835,2227,82,0,302,45,7,,,,,4131,D
20200719,NE,232401,1250,22481,120,209920,1130,301,0,1481,113,1,,,,,16801,B
20200719,NH,143378,1592,6203,38,137175,1554,398,3,673,17,3,,193,,,5251,B
20200719,NJ,1791137,9687,176783,-31,1614354,9718,15706,7,21064,766,0,149,,65,,31405,A+
20200719,NM,460664,8366,16736,280,443928,8086,569,4,2364,160,27,,,,,6736,B
20200719,NV,389788,7251,35765,1288,354023,5963,647,1,,1045,0,287,,149,,842,A+
20200719,NY,5115470,46204,406807,502,4708663,45702,25048,13,89995,722,0,160,,96,,72161,A
20200719,OH,1162914,24478,74932,1110,1087982,23368,3174,42,9555,1065,42,318,2315,163,,51086,B
20200719,OK,475940,209,25265,209,450675,0,451,0,2388,547,13,232,,,,19466,A+
20200719,OR,335590,4797,14579,430,321011,4367,260,3,1327,242,0,64,,34,,3225,A+
20200719,PA,1027379,14652,101027,786,926352,13866,7015,8,,703,0,,,96,,76780,A+
20200719,PR,204749,610,12063,610,192686,0,178,0,,315,0,26,,18,,,B
20200719,RI,179201,0,17793,0,161408,0,990,0,2088,62,0,4,,2,,1717,A+
20200719,SC,577386,15393,69986,2374,507400,13019,1155,20,4182,1593,0,,,,,22553,A
20200719,SD,98087,840,7906,44,90181,796,118,2,774,63,3,,,,,6952,B
20200719,TN,1197297,23645,78115,1779,1119182,21866,843,5,3681,1327,32,,,,,44319,A
20200719,TX,2932364,89679,325030,7300,2607334,82379,3958,93,,10592,0,,,,,172936,B
20200719,UT,462822,6582,34117,785,428705,5797,243,0,2033,296,19,102,543,,222,20915,A+
20200719,VA,907363,17662,77430,1057,829933,16605,2027,2,11203,1186,61,249,,127,,10017,A+
20200719,VI,6884,362,297,14,6587,348,6,0,,,0,,,,,135,C
20200719,VT,82500,2054,1350,12,81150,2042,56,0,,24,0,,,,,1137,B
20200719,WA,791786,24129,46026,959,745760,23170,1444,10,5033,364,49,,,62,,,B
20200719,WI,776850,8108,45948,849,730902,7259,851,1,4107,339,25,99,826,,,32628,A+
20200719,WV,230988,5477,5042,148,225946,5329,100,0,,76,0,32,,15,,3373,B
20200719,WY,44053,18,2126,18,41927,0,24,0,143,19,1,,,,,1615,B
20200718,AK,168363,2949,2159,78,166204,2871,18,1,,26,0,,,1,,708,A
20200718,AL,574495,11380,65234,2143,509261,9237,1286,21,7782,1416,198,,982,,524,29736,B
20200718,AR,413005,5508,31762,0,381243,5508,353,0,2135,464,65,,,97,304,24776,A+
20200718,AS,1037,0,0,0,1037,0,0,0,,,0,,,,,,C
20200718,AZ,771991,7023,141265,2742,630726,4281,2730,147,6567,3238,165,894,,657,,17661,A+
20200718,CA,6167218,123119,375363,9199,5791855,113920,7595,120,,8502,0,2125,,,,,B
20200718,CO,430783,6434,39344,618,391439,5816,1615,0,5994,394,28,,,,,4927,A
20200718,CT,629969,0,47893,0,582076,0,4396,0,10654,66,0,,,,,8466,B
20200718,DC,144955,3348,11194,79,133761,3269,578,1,,88,0,17,,12,,1877,A+
20200718,DE,150757,2147,13429,92,137328,2055,523,2,,51,0,8,,,,7362,A+
20200718,FL,2931988,51220,337569,10328,2594419,40892,5002,90,20969,9144,443,,,,,,A
20200718,GA,1231806,33128,139872,4689,1091934,28439,3168,36,14961,2929,314,,2819,,,,A
20200718,GU,18253,1,315,1,17938,0,5,0,,4,0,,,,,222,B
20200718,HI,102995,1791,1334,23,101661,1768,23,1,139,,1,,,,,994,D
20200718,IA,403729,1276,37907,185,365822,1091,787,3,,210,0,70,,27,,27820,A+
20200718,ID,142505,2186,13752,619,128753,1567,118,4,570,224,16,33,170,,,3827,A
20200718,IL,2213573,46099,161785,1276,2051788,44823,7483,18,,1360,0,326,,119,,,A
20200718,IN,614455,9820,55654,841,558801,8979,2820,17,7861,798,47,245,1667,84,,40722,A+
20200718,KS,249353,0,21965,0,227388,0,299,0,1453,,0,58,427,14,161,983,A
20200718,KY,490201,7139,22184,579,468017,6560,667,9,2875,514,11,109,1033,,,6824,B
20200718,LA,1043940,0,88590,0,955350,0,3509,0,,1413,0,,,161,,53288,B
20200718,MA,1026833,12246,113238,359,913595,11887,8419,17,11709,499,18,86,,43,,95390,A+
20200718,MD,720986,12770,77206,835,643780,11935,3368,9,11788,448,60,137,,,,5344,A
20200718,ME,134929,1484,3646,10,131283,1474,117,2,375,9,0,8,,5,,3136,A+
20200718,MI,1456078,30572,81338,745,1374740,29827,6364,9,,680,0,201,,102,,55162,A+
20200718,MN,835962,16451,45470,457,790492,15994,1578,5,4602,265,39,117,1377,,,39310,A
20200718,MO,550876,12980,32248,960,518628,12020,1130,9,,875,0,,,86,,,B
20200718,MP,10701,0,37,0,10664,0,2,0,4,,0,,,,,29,D
20200718,MS,377285,5821,41846,1017,335439,4804,1346,14,3727,1076,15,253,,129,,25932,A
20200718,MT,131879,1475,2471,105,129408,1370,37,0,164,46,5,,,,,1075,C
20200718,NC,1379143,35169,97958,2481,1281185,32688,1629,23,,1154,0,,,,,67124,A
20200718,ND,131515,2040,4907,115,126608,1925,82,0,295,38,5,,,,,4029,D
20200718,NE,231151,4955,22361,227,208790,4728,301,2,1480,105,27,,,,,16665,B
20200718,NH,141786,0,6165,0,135621,0,395,0,670,24,0,,192,,,5188,B
20200718,NJ,1781450,12522,176814,263,1604636,12259,15699,15,21064,800,61,141,,73,,31400,A+
20200718,NM,452298,8930,16456,318,435842,8612,565,3,2337,166,25,,,,,6654,B
20200718,NV,382537,5530,34477,1182,348060,4348,646,9,,1006,0,285,,150,,842,A+
20200718,NY,5069266,69817,406305,754,4662961,69063,25035,11,89995,743,0,172,,100,,72064,A
20200718,OH,1138436,22312,73822,1542,1064614,20770,3132,20,9513,1024,68,315,2311,159,,50280,B
20200718,OK,475731,10687,25056,916,450675,9771,451,6,2375,547,86,232,,,,19186,A+
20200718,OR,330793,6598,14149,347,316644,6251,257,3,1327,242,0,64,,34,,3225,A+
20200718,PA,1012727,13337,100241,763,912486,12574,7007,15,,699,0,,,93,,76183,A+
20200718,PR,204139,333,11453,333,192686,0,178,1,,316,0,29,,25,,,B
20200718,RI,179201,0,17793,0,161408,0,990,0,2088,62,0,4,,2,,1717,A+
20200718,SC,561993,8618,67612,1552,494381,7066,1135,39,4182,1593,0,,,,,23849,A
20200718,SD,97247,1274,7862,73,89385,1201,116,0,771,70,8,,,,,6891,B
20200718,TN,1173652,22980,76336,2517,1097316,20463,838,23,3649,1378,87,,,,,43706,A
20200718,TX,2842685,75364,317730,10158,2524955,65206,3865,130,,10658,0,,,,,169581,B
20200718,UT,456240,8434,33332,760,422908,7674,243,8,2014,251,30,91,541,,222,20421,A+
20200718,VA,889701,12997,76373,940,813328,12057,2025,12,11142,1166,88,254,,108,,9976,A+
20200718,VI,6522,469,283,20,6239,449,6,0,,,0,,,,,133,C
20200718,VT,80446,1080,1338,4,79108,1076,56,0,,25,0,,,,,1125,B
20200718,WA,767657,14483,45067,754,722590,13729,1434,7,4984,348,40,,,46,,,B
20200718,WI,768742,12477,45099,1031,723643,11446,850,10,4082,315,51,89,823,,,32004,A+
20200718,WV,225511,2959,4894,111,220617,2848,100,0,,74,0,33,,16,,3295,B
20200718,WY,44035,39,2108,39,41927,0,24,0,142,19,2,,,,,1611,B
20200717,AK,165414,2392,2081,49,163333,2343,17,0,,32,0,,,0,,697,A
20200717,AL,563115,12006,63091,2003,500024,10003,1265,35,7584,1416,0,,967,,521,29736,B
20200717,AR,407497,6536,31762,648,375735,5888,353,12,2070,464,76,,,97,298,24776,A
20200717,AS,1037,0,0,0,1037,0,0,0,,,0,,,,,,C
20200717,AZ,764968,15702,138523,3910,626445,11792,2583,91,6402,3466,106,944,,687,,17184,A+
20200717,CA,6044099,128591,366164,9986,5677935,118605,7475,130,,8450,0,2153,,,,,B
20200717,CO,424349,8133,38726,571,385623,7562,1615,14,5966,412,16,,,,,4909,A
20200717,CT,629969,14421,47893,143,582076,14278,4396,7,10654,66,0,,,,,8466,B
20200717,DC,141607,1365,11115,39,130492,1326,577,3,,87,0,17,,14,,1863,A+
20200717,DE,148610,3740,13337,223,135273,3517,521,0,,55,0,7,,,,7315,A+
20200717,FL,2880768,65150,327241,11466,2553527,53684,4912,130,20526,8961,372,,,,,,A
20200717,GA,1198678,20456,135183,3908,1063495,16548,3132,28,14647,2902,301,,2781,,,,A
20200717,GU,18252,241,314,0,17938,241,5,0,,4,0,,,,,214,B
20200717,HI,101204,1817,1311,19,99893,1798,22,0,138,,1,,,,,975,D
20200717,IA,402453,6002,37722,590,364731,5412,784,6,,210,0,70,,32,,27609,A+
20200717,ID,140319,3456,13133,688,127186,2768,114,4,554,153,28,35,165,,,3676,A
20200717,IL,2167474,43735,160509,1427,2006965,42308,7465,13,,1431,0,309,,128,,,A
20200717,IN,604635,9077,54813,733,549822,8344,2803,8,7814,815,67,258,1658,80,,40421,A+
20200717,KS,249353,9979,21965,1032,227388,8947,299,0,1453,,60,58,427,14,161,983,A
20200717,KY,483062,15058,21605,522,461457,14536,658,8,2864,452,22,89,1031,,,6772,B
20200717,LA,1043940,19803,88590,2179,955350,17624,3509,24,,1413,0,,,161,,53288,B
20200717,MA,1014587,12903,112879,298,901708,12605,8402,22,11691,515,28,76,,34,,95390,A+
20200717,MD,708216,15687,76371,707,631845,14980,3359,12,11728,434,41,128,,,,5286,A
20200717,ME,133445,2983,3636,38,129809,2945,115,1,375,12,1,11,,5,,3114,A+
20200717,MI,1425506,30352,80593,754,1344913,29598,6355,7,,680,0,201,,88,,53867,A+
20200717,MN,819511,14299,45013,666,774498,13633,1573,7,4563,252,37,110,1369,,,38568,A
20200717,MO,537896,8595,31288,866,506608,7729,1121,8,,875,0,,,86,,,B
20200717,MP,10701,1,37,1,10664,0,2,0,4,,0,,,,,29,D
20200717,MS,371464,7564,40829,1032,330635,6532,1332,24,3712,1076,37,253,,129,,25932,A
20200717,MT,130404,2564,2366,135,128038,2429,37,2,159,45,9,,,,,992,C
20200717,NC,1343974,31217,95477,2051,1248497,29166,1606,18,,1180,0,,,,,67124,A
20200717,ND,129475,1419,4792,124,124683,1295,82,0,290,36,5,,,,,3903,D
20200717,NE,226196,2967,22134,155,204062,2812,299,8,1453,96,0,,,,,16501,B
20200717,NH,141786,3514,6165,52,135621,3462,395,1,670,24,2,,192,,,5188,B
20200717,NJ,1768928,9024,176551,50,1592377,8974,15684,19,21003,868,229,141,,66,,31400,A+
20200717,NM,443368,6363,16138,297,427230,6066,562,5,2312,170,28,,,,,6578,B
20200717,NV,377007,6164,33295,1380,343712,4784,637,11,,1000,0,269,,134,,842,A+
20200717,NY,4999449,78239,405551,776,4593898,77463,25024,10,89995,765,0,179,,98,,71970,A
20200717,OH,1116124,27331,72280,1679,1043844,25652,3112,9,9445,1016,121,319,2305,161,,49302,B
20200717,OK,465044,8227,24140,699,440904,7528,445,7,2289,604,71,247,,,,18766,A+
20200717,OR,324195,5249,13802,293,310393,4956,254,5,1327,242,16,64,,34,,3199,A+
20200717,PA,999390,15749,99478,1032,899912,14717,6992,19,,680,0,,,98,,75603,A+
20200717,PR,203806,546,11120,546,192686,0,177,5,,302,0,34,,27,,,B
20200717,RI,179201,1813,17793,82,161408,1731,990,2,2088,62,4,4,,2,,1717,A+
20200717,SC,553375,13411,66060,1977,487315,11434,1096,26,4182,1593,438,,,,,23849,A
20200717,SD,95973,1937,7789,95,88184,1842,116,1,763,61,6,,,,,6808,B
20200717,TN,1150672,26975,73819,2279,1076853,24696,815,19,3562,1436,65,,,,,42734,A
20200717,TX,2767321,67466,307572,14916,2459749,52550,3735,174,,10632,0,,,,,162191,B
20200717,UT,447806,8278,32572,727,415234,7551,235,1,1984,256,28,96,532,,220,19862,A+
20200717,VA,876704,15531,75433,1002,801271,14529,2013,6,11054,1171,276,247,,118,,9883,A+
20200717,VI,6053,768,263,14,5790,754,6,0,,,0,,,,,126,C
20200717,VT,79366,326,1334,9,78032,317,56,0,,33,0,,,,,1121,B
20200717,WA,753174,19288,44313,1267,708861,18021,1427,6,4944,379,115,,,45,,,B
20200717,WI,756265,13456,44068,929,712197,12527,840,2,4031,333,63,97,816,,,31258,A+
20200717,WV,222552,3378,4783,126,217769,3252,100,1,,69,0,37,,15,,3267,B
20200717,WY,43996,544,2069,43,41927,501,24,0,140,19,9,,,,,1590,B
20200716,AK,163022,6929,2032,401,160990,6528,17,0,,32,0,,,0,,688,A
20200716,AL,551109,10060,61088,2021,490021,8039,1230,19,7584,1362,293,,950,,516,29736,B
20200716,AR,400961,5185,31114,817,369847,4368,341,6,1994,470,46,,,101,286,24195,A
20200716,AS,1037,221,0,0,1037,221,0,0,,,0,,,,,,C
20200716,AZ,749266,13304,134613,3259,614653,10045,2492,58,6296,3454,193,918,,657,,16684,A+
20200716,CA,5915508,122232,356178,8544,5559330,113688,7345,118,,8363,0,2120,,,,,B
20200716,CO,416216,6226,38155,469,378061,5757,1601,7,5950,389,-13,,,,,4880,A
20200716,CT,615548,11449,47750,114,567798,11335,4389,9,10654,66,102,,,,,8466,B
20200716,DC,140242,2298,11076,50,129166,2248,574,3,,86,0,24,,14,,1843,A+
20200716,DE,144870,1482,13114,64,131756,1418,521,0,,50,0,8,,,,7269,A+
20200716,FL,2815618,79665,315775,13965,2499843,65700,4782,156,20154,9112,495,,,,,,A
20200716,GA,1178222,23239,131275,3441,1046947,19798,3104,13,14346,2841,244,,2736,,,,A
20200716,GU,18011,184,314,1,17697,183,5,0,,4,0,,,,,214,B
20200716,HI,99387,1830,1292,28,98095,1802,22,0,137,,4,,,,,951,D
20200716,IA,396451,9139,37132,841,359319,8298,778,16,,195,0,65,,34,,27404,A+
20200716,ID,136863,2949,12445,727,124418,2222,110,7,526,153,16,35,151,,,3513,A
20200716,IL,2123739,43006,159082,1257,1964657,41749,7452,25,,1434,0,311,,127,,,A
20200716,IN,595558,8969,54080,710,541478,8259,2795,10,7747,827,61,292,1643,86,,40004,A+
20200716,KS,239374,0,20933,0,218441,0,299,0,1393,,0,65,418,21,159,948,A
20200716,KY,468004,8817,21083,406,446921,8411,650,5,2842,418,19,92,1030,,,5500,B
20200716,LA,1024137,22937,86411,2280,937726,20657,3485,24,,1401,0,,,162,,53288,B
20200716,MA,1001684,12971,112581,234,889103,12737,8380,12,11663,557,12,77,,38,,95390,A+
20200716,MD,692529,12441,75664,648,616865,11793,3347,6,11687,436,62,137,,,,5286,A
20200716,ME,130462,2531,3598,20,126864,2511,114,0,374,13,1,11,,4,,3094,A+
20200716,MI,1395154,27235,79839,926,1315315,26309,6348,18,,680,0,201,,107,,53867,A+
20200716,MN,805212,14715,44347,605,760865,14110,1566,8,4526,249,31,103,1357,,,38290,A
20200716,MO,529301,11354,30422,708,498879,10646,1113,11,,875,0,,,86,,,B
20200716,MP,10700,0,36,0,10664,0,2,0,4,,0,,,,,29,D
20200716,MS,363900,7043,39797,1230,324103,5813,1308,18,3675,1117,46,247,,125,,25932,A
20200716,MT,127840,4082,2231,135,125609,3947,35,1,150,37,5,,,,,970,C
20200716,NC,1312757,28120,93426,2160,1219331,25960,1588,20,,1134,0,,,,,67124,A
20200716,ND,128056,1492,4668,103,123388,1389,82,1,285,38,1,,,,,3796,D
20200716,NE,223229,3486,21979,262,201250,3224,291,5,1453,103,11,,,,,16324,B
20200716,NH,138272,1163,6113,22,132159,1141,394,2,668,24,3,,192,,,5125,B
20200716,NJ,1759904,17557,176501,223,1583403,17334,15665,58,20774,862,0,146,,64,,31400,A+
20200716,NM,437005,6999,15841,327,421164,6672,557,6,2284,174,23,,,,,6496,B
20200716,NV,370843,6418,31915,1447,338928,4971,626,8,,1051,0,251,,124,,834,A+
20200716,NY,4921210,72685,404775,769,4516435,71916,25014,11,89995,813,0,165,,88,,71867,A
20200716,OH,1088793,26170,70601,1290,1018192,24880,3103,28,9324,1024,115,310,2280,150,,48330,B
20200716,OK,456817,9492,23441,628,433376,8864,438,6,2218,638,48,235,,,,18095,A+
20200716,OR,318946,7160,13509,428,305437,6732,249,2,1311,219,21,63,,33,,3199,A+
20200716,PA,983641,14992,98446,781,885195,14211,6973,16,,652,0,,,95,,74818,A+
20200716,PR,203260,195,10574,195,192686,0,172,1,,280,0,25,,14,,,B
20200716,RI,177388,1513,17711,71,159677,1442,988,1,2084,64,9,4,,3,,1711,A+
20200716,SC,539964,13981,64083,1838,475881,12143,1070,72,3744,1578,0,,,,,23849,A
20200716,SD,94036,493,7694,42,86342,451,115,4,757,61,5,,,,,6737,B
20200716,TN,1123697,26024,71540,2479,1052157,23545,796,13,3497,1416,63,,,,,41250,A
20200716,TX,2699855,57656,292656,10291,2407199,47365,3561,129,,10457,0,,,,,155937,B
20200716,UT,439528,7448,31845,954,407683,6494,234,1,1956,236,43,89,523,,214,19214,A+
20200716,VA,861173,16191,74431,904,786742,15287,2007,15,10778,1134,170,248,,118,,9644,A+
20200716,VI,5285,405,249,6,5036,399,6,0,,,0,,,,,120,C
20200716,VT,79040,682,1325,7,77715,675,56,0,,25,0,,,,,1111,B
20200716,WA,733886,15652,43046,742,690840,14910,1421,17,4829,372,41,,,53,,,B
20200716,WI,742809,14313,43139,942,699670,13371,838,4,3968,310,45,88,811,,,30555,A+
20200716,WV,219174,1270,4657,100,214517,1170,99,2,,65,0,29,,13,,3128,B
20200716,WY,43452,538,2026,41,41426,497,24,2,131,18,0,,,,,1540,B
20200715,AK,156093,6620,1631,52,154462,6568,17,0,,32,0,,,0,,669,A
20200715,AL,541049,11960,59067,1812,481982,10148,1211,47,7291,1362,168,,941,,514,29736,B
20200715,AR,395776,5477,30297,564,365479,4913,335,4,1948,458,76,,,94,279,23523,A
20200715,AS,816,0,0,0,816,0,0,0,,,0,,,,,,C
20200715,AZ,735962,14019,131354,3257,604608,10762,2434,97,6103,3493,161,929,,671,,16155,A+
20200715,CA,5793276,118321,347634,11126,5445642,107195,7227,140,,8353,0,2110,,,,,B
20200715,CO,409990,5035,37686,444,372304,4591,1594,5,5963,368,22,,,,,4844,A
20200715,CT,604099,12338,47636,106,556463,12232,4380,8,10552,67,0,,,,,8351,B
20200715,DC,137944,4028,11026,80,126918,3948,571,3,,95,0,24,,15,,1809,A+
20200715,DE,143388,1788,13050,81,130338,1707,521,3,,51,0,11,,,,7236,A+
20200715,FL,2735953,50710,301810,10181,2434143,40529,4626,112,19659,8217,458,,,,,,A
20200715,GA,1154983,23949,127834,3871,1027149,20078,3091,37,14102,2786,417,,2702,,,,A
20200715,GU,17827,290,313,1,17514,289,5,0,,4,0,,,,,213,B
20200715,HI,97557,1487,1264,21,96293,1466,22,0,133,,5,,,,,921,D
20200715,IA,387312,6904,36291,442,351021,6462,762,5,,190,0,62,,30,,27177,A+
20200715,ID,133914,3630,11718,316,122196,3314,103,1,510,153,10,35,151,,,3360,A
20200715,IL,2080733,38161,157825,1187,1922908,36974,7427,8,,1454,0,324,,130,,,A
20200715,IN,586589,8180,53370,685,533219,7495,2785,10,7686,881,53,284,1634,79,,39571,A+
20200715,KS,239374,8199,20933,875,218441,7324,299,11,1393,,50,65,418,21,159,948,A
20200715,KY,459187,3631,20677,454,438510,3177,645,10,2823,445,21,92,1028,,,5475,B
20200715,LA,1001200,24745,84131,2089,917069,22656,3461,16,,1369,0,,,149,,53288,B
20200715,MA,988713,10499,112347,217,876366,10282,8368,28,11651,580,26,80,,40,,95390,A+
20200715,MD,680088,14019,75016,756,605072,13263,3341,7,11625,447,140,129,,,,5238,A
20200715,ME,127931,2456,3578,12,124353,2444,114,0,373,12,0,9,,4,,3079,A+
20200715,MI,1367919,34133,78913,1049,1289006,33084,6330,4,,543,0,184,,107,,53867,A+
20200715,MN,790497,12883,43742,572,746755,12311,1558,10,4495,254,43,106,1353,,,38179,A
20200715,MO,517947,12844,29714,888,488233,11956,1102,9,,875,0,,,86,,,B
20200715,MP,10700,3,36,3,10664,0,2,0,4,,0,,,,,29,D
20200715,MS,356857,6644,38567,1025,318290,5619,1290,18,3629,1099,44,240,,132,,25932,A
20200715,MT,123758,2362,2096,144,121662,2218,34,0,145,37,9,,,,,915,C
20200715,NC,1284637,29791,91266,1782,1193371,28009,1568,16,,1142,0,,,,,67124,A
20200715,ND,126564,1531,4565,72,121999,1459,81,3,284,42,4,,,,,3760,D
20200715,NE,219743,3508,21717,318,198026,3190,286,-2,1442,110,11,,,,,16205,B
20200715,NH,137109,1081,6091,23,131018,1058,392,1,665,23,76,,191,,,5101,B
20200715,NJ,1742347,21116,176278,363,1566069,20753,15607,25,20774,923,142,151,,78,,31400,A+
20200715,NM,430006,5651,15514,223,414492,5428,551,3,2261,171,34,,,,,6429,B
20200715,NV,364425,4245,30468,849,333957,3396,618,6,,1051,0,251,,124,,826,A+
20200715,NY,4848525,63598,404006,831,4444519,62767,25003,9,89995,831,0,165,,94,,71782,A
20200715,OH,1062623,18874,69311,1316,993312,17558,3075,6,9209,1027,160,316,2259,146,,47303,B
20200715,OK,447325,6031,22813,1075,424512,4956,432,4,2170,561,54,231,,,,17366,A+
20200715,OR,311786,6330,13081,276,298705,6054,247,3,1290,207,36,53,,30,,3129,A+
20200715,PA,968649,21366,97665,994,870984,20372,6957,26,,667,0,,,92,,74436,A+
20200715,PR,203065,256,10379,256,192686,0,171,2,,254,0,18,,11,,,B
20200715,RI,175875,1217,17640,52,158235,1165,987,2,2075,59,5,5,,3,,1707,A+
20200715,SC,525983,8502,62245,1856,463738,6646,998,5,3744,1560,0,,,,,23849,A
20200715,SD,93543,1379,7652,80,85891,1299,111,2,752,59,8,,,,,6663,B
20200715,TN,1097673,25785,69061,2273,1028612,23512,783,16,3434,1282,56,,,,,39857,A
20200715,TX,2642199,43519,282365,7307,2359834,36212,3432,110,,10471,0,,,,,149276,B
20200715,UT,432080,7559,30891,413,401189,7146,233,7,1913,250,25,83,515,,214,18593,A+
20200715,VA,844982,14132,73527,1084,771455,13048,1992,15,10608,1081,58,246,,113,,9527,A+
20200715,VI,4880,590,243,37,4637,553,6,0,,,0,,,,,112,C
20200715,VT,78358,734,1318,13,77040,721,56,0,,19,0,,,,,1104,B
20200715,WA,718234,9960,42304,547,675930,9413,1404,5,4788,353,10,,,55,,,B
20200715,WI,728496,13952,42197,848,686299,13104,834,1,3923,295,31,88,810,,,29923,A+
20200715,WV,217904,3892,4557,150,213347,3742,97,0,,63,0,26,,13,,2999,B
20200715,WY,42914,2886,1985,34,40929,2852,22,0,131,17,3,,,,,1506,B
20200714,AK,149473,2883,1579,40,147894,2843,17,0,,25,0,,,1,,642,A
20200714,AL,529089,9485,57255,1710,471834,7775,1164,40,7123,1353,378,,931,,511,25783,B
20200714,AR,390299,7325,29733,794,360566,6531,331,8,1872,445,36,,,91,273,22844,A
20200714,AS,816,0,0,0,816,0,0,0,,,0,,,,,,C
20200714,AZ,721943,19517,128097,4273,593846,15244,2337,92,5942,3517,103,970,,674,,15678,A+
20200714,CA,5674955,130590,336508,7346,5338447,123244,7087,47,,8145,0,2083,,,,,B
20200714,CO,404955,5590,37242,329,367713,5261,1589,3,5941,378,46,,,,,4808,A
20200714,CT,591761,2443,47530,20,544231,2423,4372,1,10552,66,0,,,,,8351,B
20200714,DC,133916,3696,10946,40,122970,3656,568,0,,91,0,21,,14,,1774,A+
20200714,DE,141600,2237,12969,90,128631,2147,518,1,,48,0,10,,,,7184,A+
20200714,FL,2685243,45669,291629,9194,2393614,36475,4514,133,19201,8354,384,,,,,,A
20200714,GA,1131034,23067,123963,3394,1007071,19673,3054,28,13685,2741,209,,2662,,,,A
20200714,GU,17537,195,312,0,17225,195,5,0,,3,0,,,,,210,B
20200714,HI,96070,900,1243,23,94827,877,22,3,128,,3,,,,,911,D
20200714,IA,380408,3692,35849,320,344559,3372,757,3,,186,0,67,,32,,26952,A+
20200714,ID,130284,3152,11402,500,118882,2652,102,0,500,153,23,35,144,,,3262,A
20200714,IL,2042572,28446,156638,707,1885934,27739,7419,25,,1416,0,333,,126,,,A
20200714,IN,578409,8000,52685,648,525724,7352,2775,13,7633,767,59,266,1620,73,,39155,A+
20200714,KS,231175,0,20058,0,211117,0,288,0,1343,,0,,410,,160,920,A
20200714,KY,455556,13671,20223,570,435333,13101,635,6,2802,449,11,84,1019,,,5389,B
20200714,LA,976455,23029,82042,2215,894413,20814,3445,22,,1362,0,,,146,,46334,B
20200714,MA,978214,12071,112130,303,866084,11768,8340,10,11625,560,14,93,,37,,94347,A+
20200714,MD,666069,14112,74260,733,591809,13379,3334,9,11485,415,18,118,,,,5238,A
20200714,ME,125475,1513,3566,8,121909,1505,114,0,373,17,1,7,,3,,3062,A+
20200714,MI,1333786,20359,77864,666,1255922,19693,6326,5,,543,0,184,,109,,53867,A+
20200714,MN,777614,8625,43170,398,734444,8227,1548,6,4452,236,28,107,1348,,,37749,A
20200714,MO,505103,9326,28826,936,476277,8390,1093,10,,811,0,,,74,,,B
20200714,MP,10697,-70,33,0,10664,-70,2,0,4,,0,,,,,19,D
20200714,MS,350213,6798,37542,862,312671,5936,1272,22,3585,1059,55,227,,126,,25932,A
20200714,MT,121396,2701,1952,109,119444,2592,34,2,136,29,3,,,,,884,C
20200714,NC,1254846,34360,89484,1956,1165362,32404,1552,42,,1109,0,,,,,67124,A
20200714,ND,125033,1155,4493,51,120540,1104,78,0,280,42,3,,,,,3685,D
20200714,NE,216235,4576,21399,227,194836,4349,288,3,1431,101,10,,,,,16025,B
20200714,NH,136028,1162,6068,14,129960,1148,391,0,589,24,0,,191,,,5056,B
20200714,NJ,1721231,20846,175915,393,1545316,20453,15582,22,20632,888,0,149,,79,,31318,A+
20200714,NM,424355,5998,15291,263,409064,5735,548,3,2227,172,23,,,,,6363,B
20200714,NV,360180,6987,29619,1104,330561,5883,612,19,,983,0,247,,121,,800,A+
20200714,NY,4784927,60045,403175,912,4381752,59133,24994,5,89995,820,0,167,,101,,71692,A
20200714,OH,1043749,18998,67995,1142,975754,17856,3069,5,9049,1017,134,314,2223,156,,46282,B
20200714,OK,441294,20512,21738,993,419556,19519,428,4,2116,546,53,234,,,,16635,A+
20200714,OR,305456,4744,12805,367,292651,4377,244,7,1254,235,20,64,,35,,3129,A+
20200714,PA,947283,15809,96671,929,850612,14880,6931,20,,678,0,,,95,,74436,A+
20200714,PR,202809,113,10123,113,192686,0,169,2,,206,0,14,,9,,,B
20200714,RI,174658,1415,17588,101,157070,1314,985,1,2070,69,4,5,,3,,1692,A+
20200714,SC,517481,10380,60389,2221,457092,8159,993,21,3744,1550,346,,,,,23849,A
20200714,SD,92164,786,7572,48,84592,738,109,0,744,62,2,,,,,6599,B
20200714,TN,1071888,17927,66788,1514,1005100,16413,767,18,3378,1222,94,,,,,38272,A
20200714,TX,2598680,58555,275058,10745,2323622,47810,3322,87,,10569,0,,,,,142398,B
20200714,UT,424521,6186,30478,448,394043,5738,226,10,1888,231,38,80,505,,210,18111,A+
20200714,VA,830850,16835,72443,801,758407,16034,1977,9,10550,1127,91,249,,112,,9423,A+
20200714,VI,4290,0,206,0,4084,0,6,0,,,0,,,,,96,C
20200714,VT,77624,1043,1305,4,76319,1039,56,0,,15,0,,,,,1099,B
20200714,WA,708274,22269,41757,1101,666517,21168,1399,-39,4778,332,27,,,39,,,B
20200714,WI,714544,14683,41349,967,673195,13716,833,6,3892,293,42,83,804,,,29275,A+
20200714,WV,214012,5787,4407,148,209605,5639,97,1,,59,0,24,,7,,2982,B
20200714,WY,40028,89,1951,89,38077,0,22,1,128,14,4,,,,,1462,B
20200713,AK,146590,1115,1539,60,145051,1055,17,0,,22,0,,,0,,620,A
20200713,AL,519604,8098,55545,1958,464059,6140,1124,3,6745,1335,0,,919,,505,25783,B
20200713,AR,382974,572,28939,572,354035,0,323,2,1836,439,14,,,89,269,22106,A
20200713,AS,816,0,0,0,816,0,0,0,,,0,,,,,,C
20200713,AZ,702426,6254,123824,1357,578602,4897,2245,8,5839,3373,44,936,,671,,15254,A+
20200713,CA,5544365,137766,329162,8358,5215203,129408,7040,23,,7895,0,2021,,,,,B
20200713,CO,399365,7262,36913,322,362452,6940,1586,0,5895,324,10,,,,,4780,A
20200713,CT,589318,31109,47510,223,541808,30886,4371,23,10552,74,0,,,,,8351,B
20200713,DC,130220,3337,10906,59,119314,3278,568,0,,93,0,25,,16,,1756,A+
20200713,DE,139363,1954,12879,75,126484,1879,517,0,,49,0,12,,,,7139,A+
20200713,FL,2639574,65567,282435,12624,2357139,52943,4381,35,18817,8051,227,,,,,,A
20200713,GA,1107967,24551,120569,3643,987398,20908,3026,25,13476,2600,217,,2643,,,,A
20200713,GU,17342,363,312,0,17030,363,5,0,,3,0,,,,,202,B
20200713,HI,95170,1250,1220,20,93950,1230,19,0,125,,0,,,,,890,D
20200713,IA,376716,2303,35529,458,341187,1845,754,4,,186,0,67,,32,,26664,A+
20200713,ID,127132,1871,10902,397,116230,1474,102,0,477,153,9,35,142,,,3179,A
20200713,IL,2014126,30012,155931,883,1858195,29129,7394,6,,1362,0,334,,136,,,A
20200713,IN,570409,5762,52037,425,518372,5337,2762,2,7574,764,47,255,1601,71,,38914,A+
20200713,KS,231175,13396,20058,1447,211117,11949,288,4,1343,,39,,410,,160,920,A
20200713,KY,441885,3715,19653,264,422232,3451,629,4,2791,440,12,87,1017,,,5344,B
20200713,LA,953426,18431,79827,1705,873599,16726,3423,7,,1308,0,,,142,,46334,B
20200713,MA,966143,8663,111827,230,854316,8433,8330,5,11611,570,3,89,,46,,94347,A+
20200713,MD,651957,8566,73527,418,578430,8148,3325,6,11467,386,47,108,,,,5230,A
20200713,ME,123962,1648,3558,19,120404,1629,114,0,372,18,1,8,,3,,3008,A+
20200713,MI,1313427,17272,77198,422,1236229,16850,6321,7,,543,0,184,,113,,53867,A+
20200713,MN,768989,13937,42772,491,726217,13446,1542,2,4424,247,25,114,1338,,,37199,A
20200713,MO,495777,10269,27890,447,467887,9822,1083,14,,932,0,,,89,,,B
20200713,MP,10767,0,33,0,10734,0,2,0,4,,0,,,,,19,D
20200713,MS,343415,8204,36680,393,306735,7811,1250,1,3530,1020,35,208,,110,,25932,A
20200713,MT,118695,4034,1843,85,116852,3949,32,3,133,28,5,,,,,875,C
20200713,NC,1220486,20911,87528,1827,1132958,19084,1510,7,,1040,0,,,,,67124,A
20200713,ND,123878,1399,4442,108,119436,1291,78,0,277,43,6,,,,,3653,D
20200713,NE,211659,3556,21172,174,190487,3382,285,0,1421,98,0,,,,,15860,B
20200713,NH,134866,1477,6054,30,128812,1447,391,0,589,22,0,,191,,,5027,B
20200713,NJ,1700385,14781,175522,224,1524863,14557,15560,19,20632,892,0,166,,81,,31261,A+
20200713,NM,418357,7603,15028,255,403329,7348,545,2,2204,170,17,,,,,6322,B
20200713,NV,353193,5637,28515,832,324678,4805,593,0,,953,0,250,,107,,789,A+
20200713,NY,4724882,51687,402263,557,4322619,51130,24989,10,89995,792,0,175,,103,,71643,A
20200713,OH,1024751,18365,66853,1261,957898,17104,3064,6,8915,949,73,293,2201,159,,45194,B
20200713,OK,420782,510,20745,510,400037,0,424,2,2063,499,31,186,,,,15815,A+
20200713,OR,300712,4540,12438,268,288274,4272,237,3,1234,246,54,67,,35,,3094,A+
20200713,PA,931474,7190,95742,476,835732,6714,6911,7,,682,0,,,96,,73721,A+
20200713,PR,202696,356,10010,356,192686,0,167,0,,159,0,15,,8,,,B
20200713,RI,173243,6588,17487,175,155756,6413,984,8,2066,67,15,3,,4,,1691,A+
20200713,SC,507101,14593,58168,1520,448933,13073,972,11,3398,1488,0,,,,,20957,A
20200713,SD,91378,770,7524,25,83854,745,109,0,742,63,4,,,,,6543,B
20200713,TN,1053961,35946,65274,3314,988687,32632,749,8,3284,1120,34,,,,,36996,A
20200713,TX,2540125,47371,264313,5655,2275812,41716,3235,43,,10405,0,,,,,136419,B
20200713,UT,418335,5277,30030,546,388305,4731,216,1,1850,252,26,86,487,,208,17728,A+
20200713,VA,814015,9970,71642,972,742373,8998,1968,2,10459,1129,104,243,,105,,9330,A+
20200713,VI,4290,201,206,25,4084,176,6,0,,,0,,,,,96,C
20200713,VT,76581,730,1301,5,75280,725,56,0,,10,0,,,,,1096,B
20200713,WA,686005,17539,40656,1438,645349,16101,1438,14,4751,331,89,,,35,,,B
20200713,WI,699861,6632,40382,505,659479,6127,827,0,3850,283,26,85,800,,,28670,A+
20200713,WV,208225,1189,4259,52,203966,1137,96,0,,63,0,22,,8,,2825,B
20200713,WY,39939,0,1862,0,38077,0,21,0,124,17,0,,,,,1372,B
20200712,AK,145475,2099,1479,94,143996,2005,17,0,,27,0,,,0,,615,A
20200712,AL,511506,9486,53587,1640,457919,7846,1121,7,6745,1068,0,,911,,503,25783,B
20200712,AR,382402,12753,28367,1564,354035,11189,321,8,1822,412,42,,,84,266,21591,A
20200712,AS,816,0,0,0,816,0,0,0,,,0,,,,,,C
20200712,AZ,696172,12182,122467,2537,573705,9645,2237,86,5795,3432,45,922,,631,,14829,A+
20200712,CA,5406599,130904,320804,8460,5085795,122444,7017,72,,7854,0,2020,,,,,B
20200712,CO,392103,6242,36591,400,355512,5842,1586,0,5885,324,21,,,,,4749,A
20200712,CT,558209,0,47287,0,510922,0,4348,0,10552,77,0,,,,,8351,B
20200712,DC,126883,2833,10847,46,116036,2787,568,0,,95,0,30,,17,,1737,A+
20200712,DE,137409,3294,12804,61,124605,3233,517,0,,58,0,10,,,,7120,A+
20200712,FL,2574007,98708,269811,15300,2304196,83408,4346,45,18590,7542,249,,,,,,A
20200712,GA,1083416,18543,116926,2525,966490,16018,3001,5,13259,2512,54,,2621,,,,A
20200712,GU,16979,0,312,0,16667,0,5,0,,3,0,,,,,202,B
20200712,HI,93920,1686,1200,42,92720,1644,19,0,125,,0,,,,,872,D
20200712,IA,374413,6052,35071,424,339342,5628,750,2,,177,0,54,,26,,26234,A+
20200712,ID,125261,2912,10505,577,114756,2335,102,1,468,140,19,33,139,,,3114,A
20200712,IL,1984114,38894,155048,954,1829066,37940,7388,19,,1342,0,311,,127,,,A
20200712,IN,564647,6501,51612,533,513035,5968,2760,4,7527,702,69,237,1592,68,,38623,A+
20200712,KS,217779,0,18611,0,199168,0,284,0,1304,,0,,405,,160,905,A
20200712,KY,438170,268,19389,268,418781,0,625,3,2779,370,0,75,1014,,,5322,B
20200712,LA,934995,10548,78122,1319,856873,9229,3416,13,,1243,0,,,134,,46334,B
20200712,MA,957480,11146,111597,199,845883,10947,8325,15,11608,583,8,93,,43,,94347,A+
20200712,MD,643391,14114,73109,642,570282,13472,3319,9,11420,392,67,114,,,,5230,A
20200712,ME,122314,2424,3539,19,118775,2405,114,2,371,19,3,9,,3,,2994,A+
20200712,MI,1296155,22033,76776,406,1219379,21627,6314,1,,505,0,174,,99,,53867,A+
20200712,MN,755052,12957,42281,710,712771,12247,1540,3,4399,251,33,123,1335,,,36582,A
20200712,MO,485508,10958,27443,310,458065,10648,1069,0,,883,0,,,80,,,B
20200712,MP,10767,2,33,2,10734,0,2,0,4,,0,,,,,19,D
20200712,MS,335211,868,36287,868,298924,0,1249,19,3495,963,0,202,,107,,22167,A
20200712,MT,114661,1302,1758,81,112903,1221,29,0,128,26,1,,,,,865,C
20200712,NC,1199575,23517,85701,1908,1113874,21609,1503,4,,1070,0,,,,,55318,A
20200712,ND,122479,1628,4334,91,118145,1537,78,0,271,38,8,,,,,3570,D
20200712,NE,208103,4249,20998,221,187105,4028,285,-1,1421,95,2,,,,,15724,B
20200712,NH,133389,1087,6024,33,127365,1054,391,1,589,22,4,,191,,,5013,B
20200712,NJ,1685604,24320,175298,339,1510306,23981,15541,16,20632,890,0,163,,86,,31190,A+
20200712,NM,410754,7173,14773,224,395981,6949,543,4,2187,158,26,,,,,6271,B
20200712,NV,347556,6323,27683,845,319873,5478,593,1,,895,0,239,,114,,764,A+
20200712,NY,4673195,62418,401706,677,4271489,61741,24979,5,89995,801,0,174,,102,,71565,A
20200712,OH,1006386,23351,65592,1378,940794,21973,3058,22,8842,954,72,289,2185,154,,44663,B
20200712,OK,420272,456,20235,456,400037,0,422,1,2032,499,40,186,,,,15485,A+
20200712,OR,296172,3989,12170,319,284002,3670,234,2,1180,208,0,56,,30,,3009,A+
20200712,PA,924284,11961,95266,577,829018,11384,6904,7,,652,0,,,96,,73354,A+
20200712,PR,202340,288,9654,288,192686,0,167,0,,174,0,12,,11,,,B
20200712,RI,166655,0,17312,0,149343,0,976,0,2051,61,0,4,,5,,1685,A+
20200712,SC,492508,4418,56648,1949,435860,2469,961,10,3398,1472,0,,,,,20957,A
20200712,SD,90608,1002,7499,45,83109,957,109,0,738,53,0,,,,,6522,B
20200712,TN,1018015,10901,61960,954,956055,9947,741,3,3250,1184,57,,,,,35855,A
20200712,TX,2492754,63130,258658,8196,2234096,54934,3192,80,,10410,0,,,,,132638,B
20200712,UT,413058,7706,29484,629,383574,7077,215,3,1824,276,27,84,486,,207,17303,A+
20200712,VA,804045,17710,70670,888,733375,16822,1966,4,10355,1045,64,228,,101,,9310,A+
20200712,VI,4089,282,181,14,3908,268,6,0,,,0,,,,,93,C
20200712,VT,75851,819,1296,13,74555,806,56,0,,17,0,,,,,1089,B
20200712,WA,668466,0,39218,0,629248,0,1424,0,4662,326,0,,,57,,,B
20200712,WI,693229,7645,39877,797,653352,6848,827,-1,3824,264,27,74,800,,,28318,A+
20200712,WV,207036,3213,4207,133,202829,3080,96,1,,56,0,14,,7,,2806,B
20200712,WY,39939,23,1862,23,38077,0,21,0,124,12,1,,,,,1372,B
20200711,AK,143376,1445,1385,62,141991,1383,17,0,,31,0,,,1,,598,A
20200711,AL,502020,9804,51947,1439,450073,8365,1114,10,6745,1068,3656,,904,,496,25783,B
20200711,AR,369649,4237,26803,0,342846,4237,313,0,1780,402,37,,,84,265,20642,A
20200711,AS,816,0,0,0,816,0,0,0,,,0,,,,,,C
20200711,AZ,683990,14779,119930,3038,564060,11741,2151,69,5750,3485,91,899,,620,,14394,A+
20200711,CA,5275695,99958,312344,8047,4963351,91911,6945,94,,7904,0,2021,,,,,B
20200711,CO,385861,8721,36191,666,349670,8055,1586,5,5864,328,33,,,,,4728,A
20200711,CT,558209,0,47287,0,510922,0,4348,0,10552,77,0,,,,,8351,B
20200711,DC,124050,3166,10801,58,113249,3108,568,0,,92,0,29,,17,,1717,A+
20200711,DE,134115,1407,12743,91,121372,1316,517,0,,65,0,13,,,,7002,A+
20200711,FL,2475299,53672,254511,10360,2220788,43312,4301,98,18341,7186,425,,,,,,A
20200711,GA,1064873,18525,114401,3190,950472,15335,2996,31,13205,2446,268,,2610,,,,A
20200711,GU,16979,113,312,2,16667,111,5,0,,3,0,,,,,202,B
20200711,HI,92234,1639,1158,28,91076,1611,19,0,125,,2,,,,,847,D
20200711,IA,368361,6113,34647,663,333714,5450,748,5,,178,0,56,,25,,26104,A+
20200711,ID,122349,4271,9928,500,112421,3771,101,1,449,122,17,33,138,,,3066,A
20200711,IL,1945220,32345,154094,1195,1791126,31150,7369,24,,1398,0,321,,139,,,A
20200711,IN,558146,7584,51079,779,507067,6805,2756,8,7458,714,0,237,1577,72,,38441,A+
20200711,KS,217779,0,18611,0,199168,0,284,0,1304,,0,,405,,160,905,A
20200711,KY,437902,5212,19121,451,418781,4761,622,2,2779,370,16,75,1014,,,5322,B
20200711,LA,924447,19199,76803,2167,847644,17032,3403,23,,1182,0,,,121,,46334,B
20200711,MA,946334,7718,111398,288,834936,7430,8310,14,11600,572,18,87,,44,,94347,A+
20200711,MD,629277,8214,72467,557,556810,7657,3310,7,11353,390,53,120,,,,5190,A
20200711,ME,119890,1484,3520,21,116370,1463,112,1,368,16,2,7,,4,,2972,A+
20200711,MI,1274122,27317,76370,685,1197752,26632,6313,28,,505,0,174,,99,,53867,A+
20200711,MN,742095,16270,41571,804,700524,15466,1537,4,4366,241,37,121,1325,,,36012,A
20200711,MO,474550,19725,27133,1134,447417,18591,1069,18,,883,0,,,72,,,B
20200711,MP,10765,0,31,0,10734,0,2,0,4,,0,,,,,19,D
20200711,MS,334343,4031,35419,797,298924,3234,1230,15,3495,963,40,202,,107,,22167,A
20200711,MT,113359,1181,1677,84,111682,1097,29,1,127,24,4,,,,,864,C
20200711,NC,1176058,25446,83793,2462,1092265,22984,1499,20,,1093,0,,,,,55318,A
20200711,ND,120851,1255,4243,89,116608,1166,78,0,263,31,3,,,,,3533,D
20200711,NE,203854,2840,20777,154,183077,2686,286,2,1419,95,0,,,,,15499,B
20200711,NH,132302,1251,5991,18,126311,1233,390,3,585,20,4,,190,,,4897,B
20200711,NJ,1661284,38126,174959,331,1486325,37795,15525,46,20632,872,65,166,,87,,31092,A+
20200711,NM,403581,7700,14549,298,389032,7402,539,6,2161,151,24,,,,,6181,B
20200711,NV,341233,5742,26838,930,314395,4812,592,13,,918,0,241,,122,,764,A+
20200711,NY,4610777,69203,401029,730,4209748,68473,24974,6,89995,799,0,177,,100,,71477,A
20200711,OH,983035,23482,64214,1358,918821,22124,3036,4,8770,928,69,299,2169,155,,44101,B
20200711,OK,419816,8742,19779,687,400037,8055,421,5,1992,499,43,186,,,,15136,A+
20200711,OR,292183,5413,11851,397,280332,5016,232,0,1180,208,0,56,,30,,3009,A+
20200711,PA,912323,13683,94689,813,817634,12870,6897,17,,646,0,,,97,,72910,A+
20200711,PR,202052,-62851,9366,229,192686,-63080,167,8,,174,0,12,,7,,,B
20200711,RI,166655,0,17312,0,149343,0,976,0,2051,61,0,4,,5,,1685,A+
20200711,SC,488090,12855,54699,2280,433391,10575,951,22,3398,1396,0,,,,,20956,A
20200711,SD,89606,1064,7454,53,82152,1011,109,2,738,65,12,,,,,6470,B
20200711,TN,1007114,12539,61006,1460,946108,11079,738,15,3193,1184,47,,,,,35435,A
20200711,TX,2429624,39835,250462,10351,2179162,29484,3112,99,,10083,0,,,,,127880,B
20200711,UT,405352,9378,28855,632,376497,8746,212,5,1797,269,49,84,483,,207,16897,A+
20200711,VA,786335,17610,69782,851,716553,16759,1962,4,10291,1020,96,230,,97,,9271,A+
20200711,VI,3807,181,167,14,3640,167,6,0,,,0,,,,,92,C
20200711,VT,75032,934,1283,6,73749,928,56,0,,18,0,,,,,1066,B
20200711,WA,668466,8136,39218,637,629248,7499,1424,15,4662,326,-3,,,57,,,B
20200711,WI,685584,12074,39080,981,646504,11093,828,7,3797,265,31,75,797,,,27909,A+
20200711,WV,203823,2620,4074,91,199749,2529,95,0,,56,0,14,,7,,2763,B
20200711,WY,39916,49,1839,49,38077,0,21,0,123,12,2,,,,,1361,B
20200710,AK,141931,6187,1323,51,140608,6136,17,0,,30,0,,,0,,588,A
20200710,AL,492216,21712,50508,1334,441708,20378,1104,36,3089,1183,50,,888,,493,25783,B
20200710,AR,365412,751,26803,751,338609,0,313,4,1743,402,38,,,84,260,20642,A
20200710,AS,816,0,0,0,816,0,0,0,,,0,,,,,,C
20200710,AZ,669211,16150,116892,4221,552319,11929,2082,44,5659,3432,133,876,,615,,13853,A+
20200710,CA,5175737,97303,304297,7798,4871440,89505,6851,140,,7896,0,2005,,,,,B
20200710,CO,377140,6438,35525,409,341615,6029,1581,37,5831,318,11,,,,,4691,A
20200710,CT,558209,12588,47287,78,510922,12510,4348,0,10552,77,0,,,,,8351,B
20200710,DC,120884,4961,10743,64,110141,4897,568,0,,96,0,26,,18,,1703,A+
20200710,DE,132708,2503,12652,121,120056,2382,517,0,,58,0,11,,,,6949,A+
20200710,FL,2421627,64229,244151,11433,2177476,52796,4203,92,17916,6974,437,,,,,,A
20200710,GA,1046348,26926,111211,4484,935137,22442,2965,35,12937,2443,331,,2565,,,,A
20200710,GU,16866,334,310,1,16556,333,5,0,,3,0,,,,,202,B
20200710,HI,90595,1443,1130,36,89465,1407,19,0,123,,1,,,,,840,D
20200710,IA,362248,7589,33984,744,328264,6845,743,4,,169,0,54,,26,,25891,A+
20200710,ID,118078,3458,9428,459,108650,2999,100,2,432,124,21,29,137,,,3022,A
20200710,IL,1912875,32997,152899,1327,1759976,31670,7345,16,,1436,0,306,,155,,,A
20200710,IN,550562,8270,50300,725,500262,7545,2748,9,7458,667,72,217,1577,87,,38120,A+
20200710,KS,217779,9297,18611,993,199168,8304,284,2,1304,,35,,405,,160,905,A
20200710,KY,432690,8677,18670,425,414020,8252,620,8,2763,409,16,70,1012,,,5258,B
20200710,LA,905248,25108,74636,2642,830612,22466,3380,25,,1117,0,,,122,,46334,B
20200710,MA,938616,12855,111110,213,827506,12642,8296,28,11582,632,23,98,,47,,94347,A+
20200710,MD,621063,8482,71910,463,549153,8019,3303,15,11300,385,79,122,,,,5157,A
20200710,ME,118406,2648,3499,13,114907,2635,111,0,366,15,1,7,,4,,2931,A+
20200710,MI,1246805,23252,75685,622,1171120,22630,6285,14,,505,0,174,,92,,52841,A+
20200710,MN,725825,20385,40767,604,685058,19781,1533,5,4329,227,24,124,1320,,,35442,A
20200710,MO,454825,0,25999,0,428826,0,1051,0,,886,0,,,79,,,B
20200710,MP,10765,0,31,0,10734,0,2,0,4,,0,,,,,19,D
20200710,MS,330312,5508,34622,1031,295690,4477,1215,11,3455,981,41,205,,103,,22167,A
20200710,MT,112178,3413,1593,127,110585,3286,28,3,123,21,3,,,,,855,C
20200710,NC,1150612,28801,81331,1982,1069281,26819,1479,18,,1046,0,,,,,55318,A
20200710,ND,119596,1747,4154,84,115442,1663,78,0,260,33,3,,,,,3496,D
20200710,NE,201014,3179,20623,198,180391,2981,284,2,1419,100,14,,,,,15206,B
20200710,NH,131051,1423,5973,21,125078,1402,387,1,581,24,3,,189,,,4831,B
20200710,NJ,1623158,23741,174628,388,1448530,23353,15479,31,20567,904,62,162,,94,,31014,A+
20200710,NM,395881,6194,14251,234,381630,5960,533,6,2137,154,36,,,,,6118,B
20200710,NV,335491,5713,25908,1004,309583,4709,579,8,,924,0,248,,111,,764,A+
20200710,NY,4541574,73558,400299,786,4141275,72772,24968,9,89995,826,0,178,,92,,71371,A
20200710,OH,959553,43151,62856,1525,896697,41626,3032,26,8701,928,131,289,2161,151,,43435,B
20200710,OK,411074,9320,19092,596,391982,8724,416,6,1949,487,56,217,,,,14648,A+
20200710,OR,286770,4695,11454,266,275316,4429,232,2,1180,208,18,56,,30,,3009,A+
20200710,PA,898640,18617,93876,1009,804764,17608,6880,32,,653,0,,,103,,72284,A+
20200710,PR,264903,275,9137,275,255766,0,159,0,,140,0,12,,10,,,B
20200710,RI,166655,1518,17312,69,149343,1449,976,2,2051,61,8,4,,5,,1685,A+
20200710,SC,475235,11470,52419,1728,422816,9742,929,24,3398,1438,308,,,,,20956,A
20200710,SD,88542,1232,7401,65,81141,1167,107,6,726,65,8,,,,,6408,B
20200710,TN,994575,21861,59546,1955,935029,19906,723,13,3146,1184,58,,,,,34740,A
20200710,TX,2389789,76577,240111,9765,2149678,66812,3013,95,,10002,0,,,,,122996,B
20200710,UT,395974,7241,28223,867,367751,6374,207,2,1748,229,48,79,477,,205,16261,A+
20200710,VA,768725,15297,68931,943,699794,14354,1958,21,10195,1006,174,234,,102,,9189,A+
20200710,VI,3626,112,153,9,3473,103,6,0,,,0,,,,,87,C
20200710,VT,74098,1349,1277,5,72821,1344,56,0,,11,0,,,,,1066,B
20200710,WA,660330,15258,38581,640,621749,14618,1409,15,4665,326,35,,,60,,,B
20200710,WI,673510,12746,38099,889,635411,11857,821,5,3766,274,40,77,792,,,27329,A+
20200710,WV,201203,4014,3983,157,197220,3857,95,0,,56,0,16,,7,,2756,B
20200710,WY,39867,822,1790,16,38077,806,21,0,121,12,0,,,,,1327,B
20200709,AK,135744,2343,1272,46,134472,2297,17,0,,28,0,,,0,,571,A
20200709,AL,470504,2212,49174,2212,421330,0,1068,10,3039,1125,33,,877,,490,25783,B
20200709,AR,364661,11389,26052,1540,338609,9849,309,8,1705,394,50,,,82,284,19992,A
20200709,AS,816,0,0,0,816,0,0,0,,,0,,,,,,C
20200709,AZ,653061,11991,112671,4057,540390,7934,2038,75,5526,3437,139,861,,575,,13341,A+
20200709,CA,5078434,82259,296499,7031,4781935,75228,6711,149,,7821,0,1957,,,,,B
20200709,CO,370702,5629,35116,452,335586,5177,1544,2,5820,335,79,,,,,4669,A
20200709,CT,545621,8177,47209,101,498412,8076,4348,5,10552,90,141,,,,,8351,B
20200709,DC,115923,1634,10679,37,105244,1597,568,4,,92,0,26,,14,,1662,A+
20200709,DE,130205,1171,12531,69,117674,1102,517,2,,63,0,12,,,,6901,A+
20200709,FL,2357398,37191,232718,8935,2124680,28256,4111,120,17479,,411,,,,,,A
20200709,GA,1019422,19013,106727,2837,912695,16176,2930,8,12606,2322,106,,2519,,,,A
20200709,GU,16532,392,309,2,16223,390,5,0,,3,0,,,,,202,B
20200709,HI,89152,2056,1094,23,88058,2033,19,0,122,,3,,,,,811,D
20200709,IA,354659,8308,33240,731,321419,7577,739,4,,168,0,49,,22,,26340,A+
20200709,ID,114620,3289,8969,430,105651,2859,98,4,411,120,15,28,133,,,2978,A
20200709,IL,1879878,36180,151572,1018,1728306,35162,7329,20,,1507,0,317,,153,,,A
20200709,IN,542292,6435,49575,512,492717,5923,2739,7,7386,686,21,226,1556,89,,37795,A+
20200709,KS,208482,0,17618,0,190864,0,282,0,1269,,0,,397,,160,879,A
20200709,KY,424013,8092,18245,326,405768,7766,612,4,2747,457,10,105,1007,,,4939,B
20200709,LA,880140,14403,71994,1843,808146,12560,3355,16,,1042,0,,,110,,46334,B
20200709,MA,925761,9766,110897,295,814864,9471,8268,25,11559,635,42,103,,42,,94347,A+
20200709,MD,612581,9473,71447,586,541134,8887,3288,13,11221,406,37,139,,,,5132,A
20200709,ME,115758,2820,3486,26,112272,2794,111,1,365,16,2,7,,4,,2901,A+
20200709,MI,1223553,23550,75063,512,1148490,23038,6271,9,,505,0,174,,93,,52841,A+
20200709,MN,705440,12470,40163,574,665277,11896,1528,5,4305,251,33,116,1312,,,35193,A
20200709,MO,454825,12485,25999,795,428826,11690,1051,5,,811,0,,,75,,,B
20200709,MP,10765,0,31,0,10734,0,2,0,4,,4,,,,,19,D
20200709,MS,324804,8485,33591,703,291213,7782,1204,16,3414,941,49,187,,104,,22167,A
20200709,MT,108765,2344,1466,95,107299,2249,25,2,120,24,3,,,,,796,C
20200709,NC,1121811,25129,79349,2039,1042462,23090,1461,20,,1034,0,,,,,55318,A
20200709,ND,117849,2010,4070,99,113779,1911,78,0,257,30,5,,,,,3464,D
20200709,NE,197835,2787,20425,224,177410,2563,282,0,1405,97,7,,,,,15031,B
20200709,NH,129628,1117,5952,20,123676,1097,386,2,578,22,1,,164,,,4817,B
20200709,NJ,1599417,21569,174240,201,1425177,21368,15448,25,20505,963,79,170,,104,,30938,A+
20200709,NM,389687,4445,14017,290,375670,4155,527,8,2101,154,45,,,,,6051,B
20200709,NV,329778,6125,24904,603,304874,5522,571,18,,935,0,237,,112,,759,A+
20200709,NY,4468016,65564,399513,584,4068503,64980,24959,15,89995,851,0,173,,98,,71279,A
20200709,OH,916402,1150,61331,1150,855071,0,3006,15,8570,890,81,289,2146,155,,42111,B
20200709,OK,401754,6931,18496,603,383258,6328,410,3,1893,453,89,215,,,,14100,A+
20200709,OR,282075,5808,11188,371,270887,5437,230,6,1162,192,7,59,,25,,2977,A+
20200709,PA,880023,13497,92867,719,787156,12778,6848,36,,650,0,,,102,,71507,A+
20200709,PR,264628,63197,8862,117,255766,63080,159,0,,147,0,11,,7,,,B
20200709,RI,165137,1867,17243,39,147894,1828,974,3,2043,55,0,4,,3,,1684,A+
20200709,SC,463765,9925,50691,1782,413074,8143,905,21,3090,1433,0,,,,,19181,A
20200709,SD,87310,1084,7336,94,79974,990,101,3,718,61,9,,,,,6331,B
20200709,TN,972714,21755,57591,1605,915123,20150,710,25,3088,1135,65,,,,,33609,A
20200709,TX,2313212,54504,230346,9782,2082866,44722,2918,105,,9689,0,,,,,118326,B
20200709,UT,388733,2973,27356,601,361377,2372,205,4,1700,207,22,74,472,,204,15661,A+
20200709,VA,753428,15429,67988,613,685440,14816,1937,32,10021,956,39,215,,93,,9065,A+
20200709,VI,3514,119,144,22,3370,97,6,0,,,0,,,,,81,C
20200709,VT,72749,993,1272,16,71477,977,56,0,,15,0,,,,,1054,B
20200709,WA,645072,9548,37941,521,607131,9027,1394,10,4630,329,48,,,59,,,B
20200709,WI,660764,13204,37210,800,623554,12404,816,2,3726,285,43,76,787,,,26792,A+
20200709,WV,197189,3274,3826,119,193363,3155,95,0,,50,0,15,,6,,2718,B
20200709,WY,39045,1227,1774,34,37271,1193,21,0,121,12,1,,,,,1313,B
20200708,AK,133401,1981,1226,42,132175,1939,17,0,,30,0,,,0,,563,A
20200708,AL,468292,6928,46962,1177,421330,5751,1058,25,3006,1110,45,,871,,486,22082,B
20200708,AR,353272,2617,24512,0,328760,2617,301,9,1655,358,51,,,89,254,18725,A
20200708,AS,816,120,0,0,816,120,0,0,,,0,,,,,,C
20200708,AZ,641070,12273,108614,3520,532456,8753,1963,36,5387,3421,115,871,,570,,12803,A+
20200708,CA,4996175,99805,289468,11694,4706707,88111,6562,114,,7705,0,1976,,,,,B
20200708,CO,365073,4433,34664,407,330409,4026,1542,0,5741,335,150,,,,,4669,A
20200708,CT,537444,7337,47108,75,490336,7262,4343,5,10411,88,0,,,,,8210,B
20200708,DC,114289,3912,10642,73,103647,3839,564,3,,86,0,30,,17,,1625,A+
20200708,DE,129034,349,12462,48,116572,301,515,1,,57,0,11,,,,6851,A+
20200708,FL,2320207,51013,223783,9989,2096424,41024,3991,48,17068,,335,,,,,,A
20200708,GA,1000409,20957,103890,3420,896519,17537,2922,23,12500,2215,274,,2502,,,,A
20200708,GU,16140,229,307,4,15833,225,5,0,,3,0,,,,,202,B
20200708,HI,87096,1423,1071,41,86025,1382,19,0,119,,0,,,,,797,D
20200708,IA,346351,7053,32509,480,313842,6573,735,10,,165,0,44,,23,,25974,A+
20200708,ID,111331,2790,8539,487,102792,2303,94,0,396,118,9,26,130,,,2932,A
20200708,IL,1843698,32742,150554,980,1693144,31762,7309,36,,1385,0,320,,153,,,A
20200708,IN,535857,5782,49063,437,486794,5345,2732,15,7365,667,32,217,1551,87,,37462,A+
20200708,KS,208482,6263,17618,717,190864,5546,282,2,1269,,34,,397,,160,879,A
20200708,KY,415921,6049,17919,400,398002,5649,608,6,2737,453,29,111,1007,,,4912,B
20200708,LA,865737,18139,70151,1888,795586,16251,3339,20,,1022,0,,,105,,46334,B
20200708,MA,915995,9235,110602,264,805393,8971,8243,30,11517,662,28,102,,49,,94347,A+
20200708,MD,603108,8730,70861,465,532247,8265,3275,9,11184,398,73,136,,,,5085,A
20200708,ME,112938,2032,3460,20,109478,2012,110,0,363,22,3,8,,5,,2856,A+
20200708,MI,1200003,23492,74551,651,1125452,22841,6262,11,,505,0,174,,93,,52841,A+
20200708,MN,692970,7723,39589,456,653381,7267,1523,9,4272,265,20,122,1302,,,34902,A
20200708,MO,442340,6992,25204,575,417136,6417,1046,4,,694,0,,,74,,,B
20200708,MP,10765,2547,31,0,10734,2547,2,0,,,0,,,,,19,D
20200708,MS,316319,674,32888,674,283431,0,1188,30,3365,883,50,190,,101,,22167,A
20200708,MT,106421,1094,1371,44,105050,1050,23,0,117,22,0,,,,,759,C
20200708,NC,1096682,25392,77310,1435,1019372,23957,1441,21,,994,0,,,,,55318,A
20200708,ND,115839,1482,3971,73,111868,1409,78,-3,252,26,4,,,,,3447,D
20200708,NE,195048,1975,20201,155,174847,1820,282,-1,1398,102,29,,,,,14927,B
20200708,NH,128511,631,5932,18,122579,613,384,2,577,24,3,,164,,,4758,B
20200708,NJ,1577848,17715,174039,161,1403809,17554,15423,142,20426,935,180,175,,142,,30844,A+
20200708,NM,385242,5002,13727,220,371515,4782,519,4,2056,133,23,,,,,5986,B
20200708,NV,323653,7107,24301,516,299352,6591,553,5,,876,0,233,,109,,754,A+
20200708,NY,4402452,57585,398929,692,4003523,56893,24944,20,89995,841,0,166,,97,,71185,A
20200708,OH,915252,18767,60181,1277,855071,17490,2991,21,8489,890,106,289,2127,155,,42111,B
20200708,OK,394823,5805,17893,673,376930,5132,407,3,1804,458,63,209,,,,13538,A+
20200708,OR,276267,4361,10817,212,265450,4149,224,4,1155,188,14,57,,27,,2877,A+
20200708,PA,866526,16424,92148,849,774378,15575,6812,25,,649,0,,,104,,70953,A+
20200708,PR,201431,31,8745,31,192686,0,159,2,,127,0,9,,10,,,B
20200708,RI,163270,0,17204,0,146066,0,971,2,2043,56,7,5,,5,,1683,A+
20200708,SC,453840,8549,48909,1557,404931,6992,884,38,3090,1404,0,,,,,19181,A
20200708,SD,86226,861,7242,79,78984,782,98,0,709,54,10,,,,,6280,B
20200708,TN,950959,29760,55986,2472,894973,27288,685,20,3023,1160,73,,,,,32736,A
20200708,TX,2258708,37421,220564,9979,2038144,27442,2813,98,,9610,0,,,,,113284,B
20200708,UT,385760,2911,26755,722,359005,2189,201,7,1678,236,25,76,465,,203,15178,A+
20200708,VA,737999,9882,67375,635,670624,9247,1905,24,9982,971,167,230,,98,,9011,A+
20200708,VI,3395,96,122,6,3273,90,6,0,,,0,,,,,80,C
20200708,VT,71756,643,1256,2,70500,641,56,0,,14,0,,,,,1049,B
20200708,WA,635524,6268,37420,435,598104,5833,1384,14,4582,318,38,,,52,,,B
20200708,WI,647560,10783,36410,645,611150,10138,814,2,3683,276,44,74,787,,,26305,A+
20200708,WV,193915,4068,3707,246,190208,3822,95,0,,48,0,13,,7,,2648,B
20200708,WY,37818,29,1740,29,36078,0,21,1,120,13,1,,,,,1291,B
20200707,AK,131420,7667,1184,46,130236,7621,17,1,,25,0,,,1,,560,A
20200707,AL,461364,6269,45785,907,415579,5362,1033,26,2961,1073,47,,858,,479,22082,B
20200707,AR,350655,5687,24512,259,326143,5428,292,0,1604,369,29,,,81,247,17834,A
20200707,AS,696,0,0,0,696,0,0,0,,,0,,,,,,C
20200707,AZ,628797,10956,105094,3653,523703,7303,1927,117,5272,3356,84,869,,544,,12260,A+
20200707,CA,4896370,103017,277774,6090,4618596,96927,6448,111,,7499,0,1984,,,,,B
20200707,CO,360640,4985,34257,192,326383,4793,1542,21,5591,327,26,,,,,4636,A
20200707,CT,530107,5743,47033,57,483074,5686,4338,0,10411,83,0,,,,,8210,B
20200707,DC,110377,2727,10569,54,99808,2673,561,0,,90,0,25,,20,,1574,A+
20200707,DE,128685,1506,12414,121,116271,1385,514,2,,56,0,15,,,,6815,A+
20200707,FL,2269194,35254,213794,7347,2055400,27907,3943,63,16733,,381,,,,,,A
20200707,GA,979452,20499,100470,3406,878982,17093,2899,21,12226,2096,307,,2471,,,,A
20200707,GU,15911,362,303,2,15608,360,5,0,,3,0,,,,,184,B
20200707,HI,85673,615,1030,7,84643,608,19,0,119,,1,,,,,781,D
20200707,IA,339298,3836,32029,372,307269,3464,725,2,,165,0,44,,20,,25594,A+
20200707,ID,108541,2076,8052,319,100489,1757,94,1,387,105,18,25,130,,,2907,A
20200707,IL,1810956,26994,149574,587,1661382,26407,7273,37,,1385,0,320,,153,,,A
20200707,IN,530075,3483,48626,295,481449,3188,2717,19,7333,655,48,213,1540,76,,36999,A+
20200707,KS,202219,0,16901,0,185318,0,280,0,1235,,0,,384,,158,859,A
20200707,KY,409872,9530,17519,367,392353,9163,602,9,2708,421,9,110,1003,,,4841,B
20200707,LA,847598,33953,68263,1936,779335,32017,3319,23,,1025,0,,,109,,43026,B
20200707,MA,906760,7343,110338,201,796422,7142,8213,15,11489,621,20,104,,50,,93157,A+
20200707,MD,594378,7017,70396,492,523982,6525,3266,20,11111,404,15,145,,,,5036,A
20200707,ME,110906,1356,3440,17,107466,1339,110,1,360,22,1,9,,4,,2816,A+
20200707,MI,1176511,17148,73900,631,1102611,16517,6251,30,,505,0,174,,99,,52841,A+
20200707,MN,685247,5554,39133,564,646114,4990,1514,3,4252,267,33,121,1295,,,34377,A
20200707,MO,435348,8603,24629,773,410719,7830,1042,14,,676,0,,,67,,,B
20200707,MP,8218,0,31,0,8187,0,2,0,,,0,,,,,19,D
20200707,MS,315645,957,32214,957,283431,0,1158,44,3315,885,35,173,,95,,22167,A
20200707,MT,105327,2401,1327,78,104000,2323,23,0,117,22,5,,,,,716,C
20200707,NC,1071290,19444,75875,1346,995415,18098,1420,22,,989,0,,,,,55318,A
20200707,ND,114357,775,3898,49,110459,726,81,3,248,24,3,,,,,3413,D
20200707,NE,193073,1333,20046,117,173027,1216,283,-1,1369,109,0,,,,,14759,B
20200707,NH,127880,2645,5914,17,121966,2628,382,1,574,25,4,,163,,,4706,B
20200707,NJ,1560133,10924,173878,267,1386255,10657,15281,52,20246,903,9,169,,142,,30774,A+
20200707,NM,380240,5186,13507,251,366733,4935,515,2,2033,129,27,,,,,5902,B
20200707,NV,316546,5065,23785,876,292761,4189,548,11,,849,0,236,,112,,743,A+
20200707,NY,4344867,56736,398237,588,3946630,56148,24924,11,89995,836,0,160,,103,,71091,A
20200707,OH,896485,15073,58904,948,837581,14125,2970,43,8383,849,134,289,2101,140,,41438,B
20200707,OK,389018,23867,17220,858,371798,23009,404,5,1741,426,52,182,,,,13005,A+
20200707,OR,271906,4185,10605,210,261301,3975,220,5,1141,191,16,55,,22,,2877,A+
20200707,PA,850102,16778,91299,995,758803,15783,6787,33,,637,0,,,101,,70437,A+
20200707,PR,201400,129,8714,129,192686,0,157,2,,122,0,19,,7,,,C
20200707,RI,163270,1556,17204,41,146066,1515,969,9,2036,55,17,4,,4,,1677,A+
20200707,SC,445291,5434,47352,972,397939,4462,846,19,3090,1324,208,,,,,19181,A
20200707,SD,85365,1062,7163,58,78202,1004,98,1,699,64,7,,,,,6190,B
20200707,TN,921199,16581,53514,1359,867685,15222,665,12,2950,1112,53,,,,,31827,B
20200707,TX,2221287,57558,210585,10028,2010702,47530,2715,60,,9286,0,,,,,108485,B
20200707,UT,382849,7007,26033,564,356816,6443,194,4,1653,248,49,84,455,,200,14764,A+
20200707,VA,728117,13004,66740,638,661377,12366,1881,28,9815,902,223,221,,105,,8913,A+
20200707,VI,3299,69,116,4,3183,65,6,0,,,0,,,,,79,C
20200707,VT,71113,760,1254,3,69859,757,56,0,,13,0,,,,,1039,B
20200707,WA,629256,16550,36985,1087,592271,15463,1370,11,4544,222,62,,,37,,,B
20200707,WI,636777,12634,35765,535,601012,12099,812,9,3639,254,37,69,777,,,25758,A+
20200707,WV,189847,866,3461,19,186386,847,95,0,,41,0,13,,6,,2535,B
20200707,WY,37789,2462,1711,77,36078,2385,20,0,119,10,0,,,,,1274,B
20200706,AK,123753,0,1138,0,122615,0,16,0,,19,0,,,3,,548,A
20200706,AL,455095,5209,44878,925,410217,4284,1007,0,2914,1016,5,,843,,473,22082,B
20200706,AR,344968,6075,24253,1044,320715,5031,292,6,1575,337,39,,,81,245,17834,A
20200706,AS,696,0,0,0,696,0,0,0,,,0,,,,,,C
20200706,AZ,617841,13479,101441,3352,516400,10127,1810,1,5188,3212,27,839,,533,,11836,A+
20200706,CA,4793353,113215,271684,5699,4521669,107516,6337,6,,7278,0,1937,,,,,B
20200706,CO,355655,4938,34065,199,321590,4739,1521,0,5565,286,15,,,,,4603,A
20200706,CT,524364,24695,46976,259,477388,24436,4338,3,10411,69,0,,,,,8210,B
20200706,DC,107650,1657,10515,33,97135,1624,561,2,,88,0,23,,16,,1553,A+
20200706,DE,127179,3238,12293,165,114886,3073,512,0,,54,0,15,,,,6778,A+
20200706,FL,2233940,33741,206447,6336,2027493,27405,3880,48,16352,,151,,,,,,A
20200706,GA,958953,9768,97064,1548,861889,8220,2878,18,11919,1962,144,,2441,,,,A
20200706,GU,15549,595,301,13,15248,582,5,0,,2,0,,,,,179,B
20200706,HI,85058,733,1023,24,84035,709,19,0,118,,0,,,,,777,D
20200706,IA,335462,2990,31657,304,303805,2686,723,2,,151,0,41,,15,,25121,A+
20200706,ID,106465,2199,7733,363,98732,1836,93,0,369,85,10,22,124,,,2886,A
20200706,IL,1783962,21134,148987,614,1634975,20520,7236,6,,1395,0,321,,151,,,A
20200706,IN,526592,4870,48331,323,478261,4547,2698,5,7285,613,31,229,1526,88,,36788,A+
20200706,KS,202219,10658,16901,982,185318,9676,280,3,1235,,16,,384,,158,859,A
20200706,KY,400342,4695,17152,776,383190,3919,593,8,2699,433,14,109,1000,,,4785,B
20200706,LA,813645,11191,66327,1101,747318,10090,3296,8,,964,0,,,109,,43026,B
20200706,MA,899417,7732,110137,163,789280,7569,8198,15,11469,603,6,99,,51,,93157,A+
20200706,MD,587361,7399,69904,272,517457,7127,3246,3,11096,403,25,142,,,,5029,A
20200706,ME,109550,1618,3423,8,106127,1610,109,0,359,21,0,9,,4,,2787,A+
20200706,MI,1159363,12544,73269,328,1086094,12216,6221,3,,505,0,174,,92,,52841,A+
20200706,MN,679693,5678,38569,433,641124,5245,1511,3,4219,258,49,125,1290,,,33907,A
20200706,MO,426745,7236,23856,420,402889,6816,1028,0,,740,0,,,73,,,B
20200706,MP,8218,0,31,0,8187,0,2,0,,,0,,,,,19,D
20200706,MS,314688,4547,31257,357,283431,4190,1114,3,3280,825,12,165,,98,,22167,A
20200706,MT,102926,2820,1249,37,101677,2783,23,0,112,20,0,,,,,678,C
20200706,NC,1051846,15008,74529,1546,977317,13462,1398,2,,982,0,,,,,55318,A
20200706,ND,113582,454,3849,33,109733,421,78,0,245,22,3,,,,,3350,D
20200706,NE,191740,1812,19929,102,171811,1710,284,0,1369,101,1,,,,,14641,B
20200706,NH,125235,1486,5897,40,119338,1446,381,5,570,25,1,,163,,,4684,B
20200706,NJ,1549209,14569,173611,209,1375598,14360,15229,18,20237,861,0,187,,152,,30729,A+
20200706,NM,375054,2766,13256,193,361798,2573,513,0,2006,119,18,,,,,5860,B
20200706,NV,311481,3784,22909,491,288572,3293,537,3,,748,0,201,,114,,742,A+
20200706,NY,4288131,54328,397649,518,3890482,53810,24913,9,89995,817,0,170,,103,,71040,A
20200706,OH,881412,12650,57956,805,823456,11845,2927,16,8249,837,77,267,2077,140,,40813,B
20200706,OK,365151,434,16362,434,348789,0,399,1,1689,391,4,165,,,,12432,A+
20200706,OR,267721,3520,10395,165,257326,3355,215,0,1125,183,56,61,,26,,2846,A+
20200706,PA,833324,8624,90304,450,743020,8174,6754,1,,598,0,,,107,,70437,A+
20200706,PR,201271,669,8585,669,192686,0,155,0,,115,0,18,,11,,,C
20200706,RI,161714,1559,17163,55,144551,1504,960,0,2019,61,0,9,,7,,1657,A+
20200706,SC,439857,9048,46380,1533,393477,7515,827,7,2882,1260,0,,,,,16994,A
20200706,SD,84303,300,7105,42,77198,258,97,0,692,59,1,,,,,6063,B
20200706,TN,904618,8452,52155,724,852463,7728,653,7,2897,940,26,,,,,31020,B
20200706,TX,2163729,30272,200557,5318,1963172,24954,2655,18,,8698,0,,,,,103782,B
20200706,UT,375842,4534,25469,517,350373,4017,190,6,1604,244,22,83,438,,194,14448,A+
20200706,VA,715113,5758,66102,354,649011,5404,1853,0,9592,783,16,194,,86,,8809,A+
20200706,VI,3230,59,112,1,3118,58,6,0,,,0,,,,,79,C
20200706,VT,70353,329,1251,2,69102,327,56,0,,24,0,,,,,1022,B
20200706,WA,612706,5430,35898,651,576808,4779,1359,5,4482,248,9,,,39,,,B
20200706,WI,624143,5292,35230,490,588913,4802,803,0,3602,254,16,66,772,,,25242,A+
20200706,WV,188981,4160,3442,180,185539,3980,95,1,,41,0,13,,6,,2518,B
20200706,WY,35327,0,1634,0,33693,0,20,0,119,9,0,,,,,1172,B
20200705,AK,123753,1021,1138,27,122615,994,16,0,,19,0,,,3,,548,A
20200705,AL,449886,7798,43953,1091,405933,6707,1007,0,2909,885,3,,843,,473,22082,B
20200705,AR,338893,0,23209,0,315684,0,286,0,1536,285,0,,,70,240,16726,A
20200705,AS,696,0,0,0,696,0,0,0,,,0,,,,,,C
20200705,AZ,604362,14854,98089,3536,506273,11318,1809,4,5161,3182,93,821,,531,,11361,A+
20200705,CA,4680138,127107,265985,8597,4414153,118510,6331,18,,7149,0,1907,,,,,B
20200705,CO,350717,4963,33866,247,316851,4716,1521,0,5550,283,13,,,,,4568,A
20200705,CT,499669,0,46717,0,452952,0,4335,0,10411,95,0,,,,,8210,B
20200705,DC,105993,1439,10482,35,95511,1404,559,2,,87,0,26,,18,,1542,A+
20200705,DE,123941,3248,12128,132,111813,3116,512,0,,53,0,15,,,,6740,A+
20200705,FL,2200199,53702,200111,10059,2000088,43643,3832,29,16201,,161,,,,,,A
20200705,GA,949185,22826,95516,2197,853669,20629,2860,3,11775,1805,32,,2429,,,,A
20200705,GU,14954,0,288,0,14666,0,5,0,,3,0,,,,,179,B
20200705,HI,84325,849,999,24,83326,825,19,0,118,,0,,,,,756,D
20200705,IA,332472,3461,31353,312,301119,3149,721,0,,141,0,43,,16,,24739,A+
20200705,ID,104266,3199,7370,376,96896,2823,93,0,359,71,4,19,122,,,2858,A
20200705,IL,1762828,27235,148373,639,1614455,26596,7230,6,,1326,0,304,,165,,,A
20200705,IN,521722,9434,48008,576,473714,8858,2693,6,7254,632,38,218,1526,87,,36475,A+
20200705,KS,191561,0,15919,0,175642,0,277,0,1219,,0,,377,,156,842,A
20200705,KY,395647,0,16376,0,379271,0,585,0,2685,455,0,99,996,,,4747,B
20200705,LA,802454,18312,65226,1937,737228,16375,3288,10,,926,0,,,105,,43026,B
20200705,MA,891685,5918,109974,136,781711,5782,8183,11,11463,636,2,100,,46,,93157,A+
20200705,MD,579962,6620,69632,291,510330,6329,3243,7,11071,409,37,144,,,,5029,A
20200705,ME,107932,1987,3415,18,104517,1969,109,2,359,25,1,9,,3,,2772,A+
20200705,MI,1146819,16665,72941,360,1073878,16305,6218,0,,548,0,193,,92,,52841,A+
20200705,MN,674015,28843,38136,512,635879,28331,1508,5,4170,253,31,132,1287,,,33408,A
20200705,MO,419509,7248,23436,221,396073,7027,1028,1,,739,0,,,72,,,B
20200705,MP,8218,0,31,0,8187,0,2,0,,,0,,,,,19,D
20200705,MS,310141,226,30900,226,279241,0,1111,4,3268,872,0,175,,88,,19388,A
20200705,MT,100106,1156,1212,45,98894,1111,23,0,112,20,0,,,,,678,C
20200705,NC,1036838,18542,72983,1329,963855,17213,1396,1,,949,0,,,,,45538,A
20200705,ND,113128,1200,3816,37,109312,1163,78,0,242,22,1,,,,,3324,D
20200705,NE,189928,2340,19827,167,170101,2173,284,0,1368,109,3,,,,,14340,B
20200705,NH,123749,0,5857,0,117892,0,376,0,569,25,0,,163,,,4597,B
20200705,NJ,1534640,26092,173402,369,1361238,25723,15211,22,20237,917,4,210,,151,,30660,A+
20200705,NM,372288,8914,13063,287,359225,8627,513,2,1988,121,18,,,,,5845,B
20200705,NV,307697,6468,22418,843,285279,5625,534,4,,760,0,226,,99,,727,A+
20200705,NY,4233803,63415,397131,533,3836672,62882,24904,8,89995,832,0,178,,116,,70968,A
20200705,OH,868762,20392,57151,968,811611,19424,2911,4,8172,693,61,236,2058,119,,40460,B
20200705,OK,364717,283,15928,283,348789,0,398,0,1685,391,9,165,,,,12246,A+
20200705,OR,264201,9175,10230,300,253971,8875,215,2,1069,173,0,52,,25,,2759,A+
20200705,PA,824700,9877,89854,479,734846,9398,6753,4,,592,0,,,106,,70086,A+
20200705,PR,200602,129,7916,129,192686,0,155,0,,118,0,9,,5,,,C
20200705,RI,160155,1398,17108,24,143047,1374,960,0,2019,61,0,9,,7,,1657,A+
20200705,SC,430809,10116,44847,1461,385962,8655,820,7,2882,1251,0,,,,,16994,A
20200705,SD,84003,173,7063,35,76940,138,97,0,691,59,2,,,,,6063,B
20200705,TN,896166,17562,51431,1291,844735,16271,646,9,2871,949,11,,,,,30254,B
20200705,TX,2133457,61648,195239,3449,1938218,58199,2637,29,,8181,0,,,,,100843,B
20200705,UT,371308,4592,24952,410,346356,4182,184,3,1582,237,17,84,438,,195,14147,A+
20200705,VA,709355,10126,65748,639,643607,9487,1853,4,9576,792,27,202,,95,,8784,A+
20200705,VI,3171,0,111,0,3060,0,6,0,,,0,,,,,76,C
20200705,VT,70024,627,1249,11,68775,616,56,0,,15,0,,,,,1007,B
20200705,WA,607276,7301,35247,469,572029,6832,1354,2,4473,305,10,,,56,,,B
20200705,WI,618851,5007,34740,533,584111,4474,803,0,3586,244,12,65,771,,,24899,A+
20200705,WV,184821,3392,3262,121,181559,3271,94,0,,27,0,12,,5,,2421,B
20200705,WY,35327,28,1634,28,33693,0,20,0,119,8,0,,,,,1172,B
20200704,AK,122732,2524,1111,48,121621,2476,16,1,,23,0,,,3,,544,A
20200704,AL,442088,11457,42862,997,399226,10460,1007,1,2906,800,23,,843,,473,22082,B
20200704,AR,338893,7656,23209,587,315684,7069,286,5,1536,285,19,,,70,240,16726,A
20200704,AS,696,0,0,0,696,0,0,0,,,0,,,,,,C
20200704,AZ,589508,11127,94553,2695,494955,8432,1805,17,5068,3113,50,796,,413,,10903,A+
20200704,CA,4553031,104855,257388,9153,4295643,95702,6313,50,,7092,0,1888,,,,,B
20200704,CO,345754,5464,33619,267,312135,5197,1521,0,5537,270,10,,,,,4557,A
20200704,CT,499669,0,46717,0,452952,0,4335,0,10411,95,0,,,,,8210,B
20200704,DC,104554,1745,10447,12,94107,1733,557,2,,95,0,28,,21,,1523,A+
20200704,DE,120693,2350,11996,73,108697,2277,512,0,,54,0,13,,,,6711,A+
20200704,FL,2146497,65137,190052,11458,1956445,53679,3803,18,16040,,245,,,,,,A
20200704,GA,926359,25142,93319,2826,833040,22316,2857,1,11743,1726,90,,2425,,,,A
20200704,GU,14954,405,288,2,14666,403,5,0,,3,0,,,,,179,B
20200704,HI,83476,1858,975,29,82501,1829,19,1,118,,2,,,,,754,D
20200704,IA,329011,7550,31041,612,297970,6938,721,1,,134,0,40,,16,,24604,A+
20200704,ID,101067,2358,6994,401,94073,1957,93,1,355,67,5,23,121,,,2831,A
20200704,IL,1735593,33836,147734,862,1587859,32974,7224,9,,1346,0,336,,182,,,A
20200704,IN,512288,8135,47432,517,464856,7618,2687,6,7216,632,41,218,1516,87,,36076,A+
20200704,KS,191561,0,15919,0,175642,0,277,0,1219,,0,,377,,156,842,A
20200704,KY,395647,0,16376,0,379271,0,585,0,2685,455,0,99,996,,,4747,B
20200704,LA,784142,0,63289,0,720853,0,3278,0,,852,0,,,93,,43026,B
20200704,MA,885767,7987,109838,210,775929,7777,8172,23,11461,640,25,107,,51,,93157,A+
20200704,MD,573342,9508,69341,380,504001,9128,3236,13,11034,410,61,143,,,,5025,A
20200704,ME,105945,2496,3397,24,102548,2472,107,2,358,27,0,9,,3,,2751,A+
20200704,MI,1130154,21889,72581,406,1057573,21483,6218,3,,548,0,193,,92,,52841,A+
20200704,MN,645172,0,37624,0,607548,0,1503,0,4139,270,0,132,1277,,,32347,A
20200704,MO,412261,7302,23215,385,389046,6917,1027,1,,740,0,,,73,,,B
20200704,MP,8218,0,31,0,8187,0,2,0,,,0,,,,,19,D
20200704,MS,309915,10876,30674,1904,279241,8972,1107,15,3268,872,60,175,,88,,19388,A
20200704,MT,98950,1447,1167,39,97783,1408,23,0,112,20,3,,,,,678,C
20200704,NC,1018296,19003,71654,1413,946642,17590,1395,3,,945,0,,,,,45538,A
20200704,ND,111928,1354,3779,57,108149,1297,78,0,241,22,4,,,,,3288,D
20200704,NE,187588,3454,19660,208,167928,3246,284,2,1365,111,12,,,,,14200,B
20200704,NH,123749,1562,5857,35,117892,1527,376,1,569,25,2,,163,,,4597,B
20200704,NJ,1508548,23047,173033,291,1335515,22756,15189,25,20233,983,19,205,,164,,30565,A+
20200704,NM,363374,6737,12776,256,350598,6481,511,8,1970,130,25,,,,,5802,B
20200704,NV,301229,7544,21575,857,279654,6687,530,2,,749,0,205,,97,,727,A+
20200704,NY,4170388,62403,396598,726,3773790,61677,24896,11,89995,844,0,190,,119,,70877,A
20200704,OH,848370,20213,56183,926,792187,19287,2907,4,8111,691,27,226,2052,111,,39903,B
20200704,OK,364434,580,15645,580,348789,0,398,0,1676,391,15,165,,,,11965,A+
20200704,OR,255026,294,9930,294,245096,0,213,4,1069,173,0,52,,25,,2759,A+
20200704,PA,814823,10679,89375,634,725448,10045,6749,3,,589,0,,,102,,69712,A+
20200704,PR,200473,104,7787,104,192686,0,155,1,,100,0,8,,4,,,C
20200704,RI,158757,979,17084,27,141673,952,960,0,2019,61,0,9,,7,,1657,A+
20200704,SC,420693,11661,43386,1854,377307,9807,813,20,2882,1190,0,,,,,16994,A
20200704,SD,83830,837,7028,50,76802,787,97,0,689,54,2,,,,,6062,B
20200704,TN,878604,16115,50140,1428,828464,14687,637,4,2860,949,35,,,,,30043,B
20200704,TX,2071809,57903,191790,8258,1880019,49645,2608,33,,7890,0,,,,,97430,B
20200704,UT,366716,10080,24542,676,342174,9404,181,0,1565,255,36,88,436,,194,13807,A+
20200704,VA,699229,10869,65109,716,634120,10153,1849,4,9549,808,20,207,,99,,8741,A+
20200704,VI,3171,110,111,13,3060,97,6,0,,,0,,,,,76,C
20200704,VT,69397,1002,1238,2,68159,1000,56,0,,16,0,,,,,999,B
20200704,WA,599975,14986,34778,627,565197,14359,1352,10,4463,315,21,,,58,,,B
20200704,WI,613844,6860,34207,776,579637,6084,803,0,3574,235,19,67,771,,,24491,A+
20200704,WV,181429,727,3141,15,178288,712,94,1,,25,0,11,,4,,2402,B
20200704,WY,35299,24,1606,24,33693,0,20,0,119,8,0,,,,,1169,B
20200703,AK,120208,4299,1063,46,119145,4253,15,1,,25,0,,,3,,539,A
20200703,AL,430631,10903,41865,1754,388766,9149,1006,21,2883,812,48,,838,,474,22082,B
20200703,AR,331237,7250,22622,547,308615,6703,281,2,1517,285,40,,,70,236,16164,A
20200703,AS,696,0,0,0,696,0,0,0,,,0,,,,,,C
20200703,AZ,578381,17542,91858,4433,486523,13109,1788,31,5018,3013,102,741,,489,,10478,A+
20200703,CA,4448176,109458,248235,5688,4199941,103770,6263,100,,7024,0,1871,,,,,B
20200703,CO,340290,7035,33352,323,306938,6712,1521,1,5527,270,14,,,,,4541,A
20200703,CT,499669,10463,46717,71,452952,10392,4335,9,10411,95,0,,,,,8210,B
20200703,DC,102809,1746,10435,45,92374,1701,555,1,,110,0,38,,24,,1497,A+
20200703,DE,118343,3425,11923,192,106420,3233,512,2,,57,0,13,,,,6692,A+
20200703,FL,2081360,49177,178594,9488,1902766,39689,3785,67,15795,,341,,,,,,A
20200703,GA,901217,17978,90493,2784,810724,15194,2856,7,11653,1671,153,,2413,,,,A
20200703,GU,14549,616,286,6,14263,610,5,0,,2,0,,,,,179,B
20200703,HI,81618,1328,946,20,80672,1308,18,0,116,,0,,,,,746,D
20200703,IA,321461,3923,30429,220,291032,3703,720,2,,146,0,40,,20,,24338,A+
20200703,ID,98709,3588,6593,223,92116,3365,92,0,350,64,10,23,121,,,2801,A
20200703,IL,1701757,34387,146872,937,1554885,33450,7215,27,,1349,0,334,,164,,,A
20200703,IN,504153,7318,46915,528,457238,6790,2681,19,7175,633,36,217,1506,81,,35756,A+
20200703,KS,191561,8388,15919,929,175642,7459,277,5,1219,,24,,377,,156,842,A
20200703,KY,395647,9853,16376,297,379271,9556,585,4,2685,455,23,99,996,,,4747,B
20200703,LA,784142,16768,63289,1728,720853,15040,3278,23,,852,0,,,93,,43026,B
20200703,MA,877780,11522,109628,290,768152,11232,8149,17,11436,656,44,106,,55,,93157,A+
20200703,MD,563834,10659,68961,538,494873,10121,3223,11,10973,422,34,143,,,,5023,A
20200703,ME,103449,2632,3373,45,100076,2587,105,0,358,27,4,9,,3,,2731,A+
20200703,MI,1108265,23128,72175,497,1036090,22631,6215,3,,548,0,193,,92,,51099,A+
20200703,MN,645172,14745,37624,414,607548,14331,1503,8,4139,270,27,132,1277,,,32347,A
20200703,MO,404959,7641,22830,547,382129,7094,1026,4,,716,0,,,78,,,B
20200703,MP,8218,1,31,1,8187,0,2,0,,,0,,,,,19,D
20200703,MS,299039,0,28770,0,270269,0,1092,0,3208,863,0,167,,94,,19388,A
20200703,MT,97503,2354,1128,45,96375,2309,23,1,109,17,3,,,,,678,C
20200703,NC,999293,28173,70241,2099,929052,26074,1392,1,,951,0,,,,,45538,A
20200703,ND,110574,2379,3722,65,106852,2314,78,0,237,20,3,,,,,3266,D
20200703,NE,184134,1472,19452,142,164682,1330,282,6,1353,121,10,,,,,14022,B
20200703,NH,122187,1880,5822,20,116365,1860,375,2,567,31,2,,162,,,4508,B
20200703,NJ,1485501,21588,172742,386,1312759,21202,15164,57,20214,1028,73,216,,167,,30464,A+
20200703,NM,356637,6577,12520,244,344117,6333,503,3,1945,127,17,,,,,5627,B
20200703,NV,293685,8957,20718,985,272967,7972,528,3,,704,0,219,,87,,727,A+
20200703,NY,4107985,66392,395872,918,3712113,65474,24885,8,89995,857,0,188,,125,,70794,A
20200703,OH,828157,34851,55257,1091,772900,33760,2903,0,8084,740,46,233,2044,100,,39423,B
20200703,OK,363854,10804,15065,526,348789,10278,398,3,1661,391,46,165,,,,11519,A+
20200703,OR,254732,3678,9636,342,245096,3336,209,0,1069,173,0,52,,25,,2759,A+
20200703,PA,804144,13871,88741,667,715403,13204,6746,34,,598,0,,,105,,69217,A+
20200703,PR,200369,75,7683,75,192686,0,154,1,,104,0,11,,6,,,C
20200703,RI,157778,695,17057,22,140721,673,960,1,2019,61,8,9,,7,,1657,A+
20200703,SC,409032,7631,41532,1831,367500,5800,793,9,2882,1148,28,,,,,16994,A
20200703,SD,82993,1052,6978,85,76015,967,97,0,687,58,4,,,,,6049,B
20200703,TN,862489,24035,48712,1822,813777,22213,633,13,2825,949,50,,,,,29591,B
20200703,TX,2013906,38103,183532,7555,1830374,30548,2575,50,,7652,0,,,,,93572,B
20200703,UT,356636,10250,23866,596,332770,9654,181,5,1529,232,24,85,434,,193,13408,A+
20200703,VA,688360,14104,64393,658,623967,13446,1845,29,9529,818,145,207,,95,,8711,A+
20200703,VI,3061,45,98,6,2963,39,6,0,,,0,,,,,75,C
20200703,VT,68395,1054,1236,9,67159,1045,56,0,,16,0,,,,,967,B
20200703,WA,584989,13025,34151,716,550838,12309,1342,3,4442,334,40,,,62,,,B
20200703,WI,606984,10229,33431,622,573553,9607,803,3,3555,244,36,75,768,,,24043,A+
20200703,WV,180702,2361,3126,73,177576,2288,93,0,,25,0,11,,4,,2396,B
20200703,WY,35275,32,1582,32,33693,0,20,0,119,8,0,,,,,1154,B
20200702,AK,115909,1509,1017,39,114892,1470,14,0,,18,0,,,1,,535,A
20200702,AL,419728,5775,40111,1149,379617,4626,985,13,2835,843,32,,826,,468,22082,B
20200702,AR,323987,9129,22075,878,301912,8251,279,2,1477,272,29,,,72,231,15698,A
20200702,AS,696,0,0,0,696,0,0,0,,,0,,,,,,C
20200702,AZ,560839,11243,87425,3333,473414,7910,1757,37,4916,2938,79,723,,488,,10137,A+
20200702,CA,4338718,84542,242547,6408,4096171,78134,6163,73,,6812,0,1934,,,,,B
20200702,CO,333255,5752,33029,314,300226,5438,1520,0,5513,262,24,,,,,4524,A
20200702,CT,489206,11365,46646,74,442560,11291,4326,2,10411,101,143,,,,,8210,B
20200702,DC,101063,1028,10390,25,90673,1003,554,1,,120,0,33,,28,,1465,A+
20200702,DE,114918,3534,11731,221,103187,3313,510,1,,67,0,16,,,,6678,A+
20200702,FL,2032183,51829,169106,10109,1863077,41720,3718,68,15454,,329,,,,,,A
20200702,GA,883239,28201,87709,3472,795530,24729,2849,22,11500,1649,225,,2389,,,,A
20200702,GU,13933,149,280,13,13653,136,5,0,,1,0,,,,,179,B
20200702,HI,80290,1232,926,9,79364,1223,18,0,116,,3,,,,,741,D
20200702,IA,317538,7748,30209,758,287329,6990,718,1,,145,0,36,,18,,23993,A+
20200702,ID,95121,4081,6370,253,88751,3828,92,0,340,69,10,17,118,,,4393,A
20200702,IL,1667370,30262,145935,869,1521435,29393,7188,36,,1651,0,349,,195,,,A
20200702,IN,496835,7119,46387,435,450448,6684,2662,12,7139,644,44,221,1493,89,,35405,A+
20200702,KS,183173,0,14990,0,168183,0,272,0,1195,,43,,367,,152,834,A
20200702,KY,385794,8704,16079,237,369715,8467,581,9,2662,430,27,73,994,,,4726,B
20200702,LA,767374,15286,61561,1383,705813,13903,3255,17,,840,0,,,91,,43026,B
20200702,MA,866258,7823,109338,195,756920,7628,8132,51,11392,681,40,113,,52,,93157,A+
20200702,MD,553175,10571,68423,505,484752,10066,3212,7,10939,441,37,149,,,,5013,A
20200702,ME,100817,3576,3328,34,97489,3542,105,0,354,30,3,9,,3,,2698,A+
20200702,MI,1085137,23278,71678,589,1013459,22689,6212,14,,548,0,193,,103,,51099,A+
20200702,MN,630427,13320,37210,494,593217,12826,1495,13,4112,274,31,123,1266,,,32163,A
20200702,MO,397318,7578,22283,356,375035,7222,1022,5,,716,0,,,77,,,B
20200702,MP,8217,0,30,0,8187,0,2,0,,,0,,,,,19,D
20200702,MS,299039,5287,28770,870,270269,4417,1092,10,3208,863,31,167,,94,,19388,A
20200702,MT,95149,1819,1083,67,94066,1752,22,0,106,14,1,,,,,672,C
20200702,NC,971120,28882,68142,1629,902978,27253,1391,18,,912,0,,,,,45538,A
20200702,ND,108195,969,3657,42,104538,927,78,0,234,19,0,,,,,3235,D
20200702,NE,182662,2054,19310,133,163352,1921,276,2,1343,117,13,,,,,13807,B
20200702,NH,120307,1138,5802,20,114505,1118,373,2,565,32,0,,162,,,4491,B
20200702,NJ,1463913,20976,172356,428,1291557,20548,15107,29,20141,1027,87,216,,170,,30383,A+
20200702,NM,350060,5879,12276,129,337784,5750,500,3,1928,127,26,,,,,5514,B
20200702,NV,284728,632,19733,632,264995,0,525,14,,662,0,196,,78,,727,A+
20200702,NY,4041593,69945,394954,875,3646639,69070,24877,11,89995,878,0,209,,129,,70698,A
20200702,OH,793306,1301,54166,1301,739140,0,2903,27,8038,724,127,244,2035,116,,38987,B
20200702,OK,353050,6737,14539,427,338511,6310,395,6,1615,368,62,163,,,,11048,A+
20200702,OR,251054,7694,9294,363,241760,7331,209,1,1069,173,14,52,,25,,2759,A+
20200702,PA,790273,13469,88074,832,702199,12637,6712,63,,631,0,,,106,,68697,A+
20200702,PR,200294,71,7608,71,192686,0,153,0,,97,0,8,,3,,,C
20200702,RI,157083,1044,17035,59,140048,985,959,3,2011,67,4,11,,10,,1644,A+
20200702,SC,401401,11529,39701,1782,361700,9747,784,18,2854,1125,0,,,,,15471,A
20200702,SD,81941,998,6893,67,75048,931,97,4,683,64,9,,,,,5982,B
20200702,TN,838454,20568,46890,1575,791564,18993,620,11,2775,949,60,,,,,28938,B
20200702,TX,1975803,53855,175977,7915,1799826,45940,2525,44,,7382,0,,,,,90720,B
20200702,UT,346386,3028,23270,554,323116,2474,176,3,1505,229,29,81,430,,190,13076,A+
20200702,VA,674256,15623,63735,532,610521,15091,1816,30,9384,888,361,206,,95,,8496,A+
20200702,VI,3016,50,92,2,2924,48,6,0,,,0,,,,,75,C
20200702,VT,67341,1049,1227,17,66114,1032,56,0,,21,0,,,,,960,B
20200702,WA,571964,14689,33435,611,538529,14078,1339,7,4402,311,41,,,57,,,B
20200702,WI,596755,12923,32809,584,563946,12339,800,7,3519,236,37,74,763,,,23527,A+
20200702,WV,178341,4989,3053,121,175288,4868,93,0,,23,0,10,,5,,2380,B
20200702,WY,35243,1544,1550,36,33693,1508,20,0,119,9,2,,,,,1139,B
20200701,AK,114400,2215,978,38,113422,2177,14,0,,20,0,,,2,,528,A
20200701,AL,413953,7301,38962,917,374991,6384,972,22,2803,797,34,,814,,464,18866,B
20200701,AR,314858,3655,21197,420,293661,3235,277,7,1448,275,35,,,72,224,15163,A
20200701,AS,696,0,0,0,696,0,0,0,,,0,,,,,,C
20200701,AZ,549596,17240,84092,4877,465504,12363,1720,88,4837,2876,101,675,,466,,9715,A+
20200701,CA,4254176,87037,236139,7407,4018037,79630,6090,110,,6612,0,1859,,,,,B
20200701,CO,327503,3646,32715,204,294788,3442,1520,12,5489,237,47,,,,,4502,A
20200701,CT,477841,11447,46572,58,431269,11389,4324,2,10268,100,0,,,,,8053,B
20200701,DC,100035,2740,10365,38,89670,2702,553,2,,119,0,33,,26,,1451,A+
20200701,DE,111384,503,11510,36,99874,467,509,0,,68,0,13,,,,6676,A+
20200701,FL,1980354,35359,158997,6563,1821357,28796,3650,46,15125,,246,,,,,,A
20200701,GA,855038,21160,84237,2946,770801,18214,2827,22,11275,1570,224,,2357,,,,A
20200701,GU,13784,469,267,8,13517,461,5,0,,0,0,,,,,179,B
20200701,HI,79058,1315,917,17,78141,1298,18,0,113,,2,,,,,736,D
20200701,IA,309790,5602,29451,444,280339,5158,717,2,,149,0,37,,21,,23607,A+
20200701,ID,91040,1737,6117,365,84923,1372,92,1,330,75,8,18,116,,,4233,A
20200701,IL,1637108,33090,145066,828,1492042,32262,7152,28,,1511,0,384,,189,,,A
20200701,IN,489716,5520,45952,358,443764,5162,2650,10,7095,668,30,232,1483,103,,35025,A+
20200701,KS,183173,6448,14990,547,168183,5901,272,2,1152,,0,,367,,152,834,A
20200701,KY,377090,6156,15842,218,361248,5938,572,7,2635,427,14,73,1007,,,4052,B
20200701,LA,752088,23577,60178,2083,691910,21494,3238,17,,799,0,,,84,,43026,B
20200701,MA,858435,10294,109143,261,749292,10033,8081,27,11352,760,15,123,,65,,93157,A+
20200701,MD,542604,6749,67918,359,474686,6390,3205,15,10902,461,58,154,,,,5001,A
20200701,ME,97241,2289,3294,41,93947,2248,105,0,351,29,3,8,,3,,2671,A
20200701,MI,1061859,16802,71089,361,990770,16441,6198,5,,471,0,179,,103,,51099,A+
20200701,MN,617107,11791,36716,413,580391,11378,1482,6,4081,260,27,125,1258,,,31947,A
20200701,MO,389740,16733,21927,376,367813,16357,1017,2,,592,0,,,75,,,B
20200701,MP,8217,0,30,0,8187,0,2,0,,,0,,,,,19,D
20200701,MS,293752,6206,27900,653,265852,5553,1082,9,3177,786,21,160,,85,,19388,A
20200701,MT,93330,2469,1016,49,92314,2420,22,0,105,14,4,,,,,658,C
20200701,NC,942238,32205,66513,1843,875725,30362,1373,30,,901,0,,,,,45538,A
20200701,ND,107226,1104,3615,39,103611,1065,78,0,234,20,3,,,,,3210,D
20200701,NE,180608,2451,19177,135,161431,2316,274,5,1330,120,0,,,,,13737,B
20200701,NH,119169,871,5782,22,113387,849,371,4,565,37,0,,162,,,4463,B
20200701,NJ,1442937,20563,171928,261,1271009,20302,15078,43,20054,1080,207,217,,178,,30300,A+
20200701,NM,344181,6461,12147,165,332034,6296,497,4,1902,127,26,,,,,5393,B
20200701,NV,284096,6528,19101,645,264995,5883,511,4,,630,0,142,,74,,714,A+
20200701,NY,3971648,56710,394079,625,3577569,56085,24866,11,89995,879,0,226,,139,,70590,A
20200701,OH,792005,4076,52865,1076,739140,3000,2876,13,7911,724,72,244,2008,116,,,B
20200701,OK,346313,4716,14112,355,332201,4361,389,2,1553,374,33,159,,,,10605,A+
20200701,OR,243360,5726,8931,275,234429,5451,208,1,1055,192,17,62,,24,,2722,A+
20200701,PA,776804,12617,87242,636,689562,11981,6649,0,,632,0,,,111,,68048,A+
20200701,PR,200223,72,7537,72,192686,0,153,0,,121,0,7,,3,,,C
20200701,RI,156039,1956,16976,65,139063,1891,956,6,2007,69,6,11,,11,,1638,A+
20200701,SC,389872,9300,37919,1520,351953,7780,766,27,2854,1160,0,,,,,15471,A
20200701,SD,80943,855,6826,62,74117,793,93,2,674,65,8,,,,,5933,B
20200701,TN,817886,24759,45315,1806,772571,22953,609,5,2715,955,50,,,,,28283,B
20200701,TX,1921948,52666,168062,8076,1753886,44590,2481,57,,6904,0,,,,,87556,B
20200701,UT,343358,2605,22716,499,320642,2106,173,1,1476,261,32,84,423,,187,12707,A+
20200701,VA,658633,13599,63203,416,595430,13183,1786,23,9023,892,41,205,,95,,8131,A+
20200701,VI,2966,63,90,6,2876,57,6,0,,,0,,,,,73,C
20200701,VT,66292,528,1210,2,65082,526,56,0,,17,0,,,,,961,B
20200701,WA,557275,9055,32824,571,524451,8484,1332,12,4361,288,38,,,50,,,B
20200701,WI,583832,12631,32225,563,551607,12068,793,9,3482,237,36,77,757,,,23089,A+
20200701,WV,173352,1588,2932,27,170420,1561,93,0,,23,0,5,,3,,2284,B
20200701,WY,33699,27,1514,27,32185,0,20,0,117,9,0,,,,,1119,B
20200630,AK,112185,3476,940,36,111245,3440,14,0,,18,0,,,1,,526,A
20200630,AL,406652,13359,38045,870,368607,12489,950,21,2769,776,44,,806,,458,18866,B
20200630,AR,311203,8667,20777,520,290426,8147,270,5,1413,290,33,,,67,220,14531,A
20200630,AS,696,0,0,0,696,0,0,0,,,0,,,,,,C
20200630,AZ,532356,20933,79215,4682,453141,16251,1632,44,4736,2793,102,683,,455,,9411,A+
20200630,CA,4167139,105447,228732,9480,3938407,95967,5980,44,,6466,0,1751,,,,,B
20200630,CO,323857,4292,32511,204,291346,4088,1508,26,5442,271,41,,,,,4479,A
20200630,CT,466394,21418,46514,152,419880,21266,4322,2,10268,98,0,,,,,8053,B
20200630,DC,97295,1935,10327,35,86968,1900,551,0,,126,0,33,,22,,1270,A+
20200630,DE,110881,950,11474,98,99407,852,509,2,,64,0,13,,,,6667,A+
20200630,FL,1944995,32252,152434,6093,1792561,26159,3604,58,14879,,228,,,,,,A
20200630,GA,833878,10761,81291,1874,752587,8887,2805,21,11051,1459,227,,2323,,,,A
20200630,GU,13315,401,259,4,13056,397,5,0,,0,0,,,,,179,B
20200630,HI,77743,588,900,1,76843,587,18,0,111,,0,,,,,722,D
20200630,IA,304188,3343,29007,225,275181,3118,715,7,,133,0,34,,20,,23212,A+
20200630,ID,89303,2958,5752,433,83551,2525,91,0,322,60,10,18,114,,,4073,A
20200630,IL,1604018,31069,144238,724,1459780,30345,7124,21,,1560,0,401,,185,,,A
20200630,IN,484196,7677,45594,366,438602,7311,2640,16,7065,695,41,272,1477,97,,34646,A+
20200630,KS,176725,0,14443,0,162282,0,270,0,1152,,0,,360,,152,794,A
20200630,KY,370934,9493,15624,277,355310,9216,565,5,2621,408,19,75,1019,,,3990,B
20200630,LA,728511,23874,58095,1014,670416,22860,3221,22,,781,0,,,83,,42225,B
20200630,MA,848141,5854,108882,114,739259,5740,8054,-41,11337,733,-8,120,,63,,93157,A+
20200630,MD,535855,6542,67559,305,468296,6237,3190,15,10844,452,22,152,,,,4982,A
20200630,ME,94952,1429,3253,34,91699,1395,105,0,348,29,1,9,,4,,2646,A
20200630,MI,1045057,15682,70728,505,974329,15177,6193,32,,471,0,179,,98,,51099,A+
20200630,MN,605316,12361,36303,442,569013,11919,1476,6,4054,270,23,136,1258,,,31601,A
20200630,MO,373007,5601,21551,508,351456,5093,1015,17,,599,0,,,66,,,B
20200630,MP,8217,0,30,0,8187,0,2,0,,,0,,,,,19,D
20200630,MS,287546,4024,27247,680,260299,3344,1073,14,3156,779,41,167,,91,,19388,A
20200630,MT,90861,2118,967,48,89894,2070,22,0,101,12,1,,,,,642,C
20200630,NC,910033,23728,64670,1186,845363,22542,1343,18,,908,0,,,,,45538,A
20200630,ND,106122,431,3576,37,102546,394,78,1,231,25,4,,,,,3195,D
20200630,NE,178157,2885,19042,143,159115,2742,269,2,1330,121,14,,,,,13547,B
20200630,NH,118298,0,5760,0,112538,0,367,0,565,34,0,,162,,,4435,B
20200630,NJ,1422374,18390,171667,395,1250707,17995,15035,43,19847,992,0,211,,174,,30213,A+
20200630,NM,337720,6672,11982,173,325738,6499,493,1,1876,119,11,,,,,5296,B
20200630,NV,277568,4551,18456,562,259112,3989,507,3,,593,0,134,,65,,689,A+
20200630,NY,3914938,52025,393454,524,3521484,51501,24855,13,89995,891,0,217,,137,,70487,A
20200630,OH,787929,13547,51789,743,736140,12804,2863,45,7839,722,93,242,1994,115,,,B
20200630,OK,341597,15404,13757,585,327840,14819,387,2,1520,315,31,111,,,,10085,A+
20200630,OR,237634,2501,8656,171,228978,2330,207,3,1038,149,13,42,,25,,2722,A+
20200630,PA,764187,11298,86606,618,677581,10680,6649,35,,634,0,,,110,,67552,A+
20200630,PR,200151,215,7465,215,192686,0,153,0,,102,0,9,,2,,,C
20200630,RI,154083,1014,16911,40,137172,974,950,4,2001,74,6,13,,13,,1631,A+
20200630,SC,380572,11267,36399,1755,344173,9512,739,19,2854,1021,232,,,,,15471,A
20200630,SD,80088,631,6764,48,73324,583,91,0,666,62,9,,,,,5872,B
20200630,TN,793127,15921,43509,1212,749618,14709,604,12,2665,886,66,,,,,27599,B
20200630,TX,1869282,50093,159986,6975,1709296,43118,2424,21,,6533,0,,,,,84818,B
20200630,UT,340753,6848,22217,553,318536,6295,172,4,1444,250,27,83,406,,178,12398,A+
20200630,VA,645034,8662,62787,598,582247,8064,1763,23,8982,902,159,230,,98,,8080,A+
20200630,VI,2903,76,84,3,2819,73,6,0,,,0,,,,,73,C
20200630,VT,65764,771,1208,0,64556,771,56,0,,16,0,,,,,953,B
20200630,WA,548220,13777,32253,501,515967,13276,1320,10,4323,282,48,,,50,,,B
20200630,WI,571201,12809,31662,629,539539,12180,784,0,3446,242,39,79,750,,,22587,A+
20200630,WV,171764,2109,2905,35,168859,2074,93,0,,27,0,10,,3,,2272,B
20200630,WY,33672,1816,1487,37,32185,1779,20,0,117,6,5,,,,,1097,B
20200629,AK,108709,409,904,21,107805,388,14,0,,16,0,,,1,,525,A
20200629,AL,393293,7013,37175,1734,356118,5279,929,10,2725,715,22,,801,,457,18866,B
20200629,AR,302536,11314,20257,947,282279,10367,265,6,1380,300,7,,,63,211,14066,A
20200629,AS,696,0,0,0,696,0,0,0,,,0,,,,,,C
20200629,AZ,511423,1527,74533,625,436890,902,1588,0,4634,2721,17,679,,465,,9179,A+
20200629,CA,4061692,105740,219252,8009,3842440,97731,5936,31,,6179,0,1686,,,,,B
20200629,CO,319565,5854,32307,285,287258,5569,1482,0,5401,234,2,,,,,4459,A
20200629,CT,444976,6353,46362,59,398614,6294,4320,4,10268,99,0,,,,,8053,B
20200629,DC,95360,2228,10292,44,85068,2184,551,1,,121,0,34,,23,,1200,A+
20200629,DE,109931,3585,11376,150,98555,3435,507,0,,72,0,15,,,,6665,A+
20200629,FL,1912743,30846,146341,5266,1766402,25580,3546,28,14651,,111,,,,,,A
20200629,GA,823117,16179,79417,2207,743700,13972,2784,6,10824,1359,113,,2289,,,,A
20200629,GU,12914,536,255,7,12659,529,5,0,,0,0,,,,,179,B
20200629,HI,77155,1677,899,27,76256,1650,18,0,111,,1,,,,,719,D
20200629,IA,300845,4930,28782,293,272063,4637,708,3,,119,0,35,,18,,17851,A+
20200629,ID,86345,0,5319,0,81026,0,91,0,312,50,0,17,111,,,3898,A
20200629,IL,1572949,26918,143514,738,1429435,26180,7103,14,,1501,0,372,,187,,,A
20200629,IN,476519,5984,45228,298,431291,5686,2624,5,7024,626,21,265,1469,85,,34348,A+
20200629,KS,176725,8866,14443,905,162282,7961,270,6,1152,,24,,360,,152,794,A
20200629,KY,361441,2950,15347,115,346094,2835,560,2,2602,381,12,69,999,,,3939,B
20200629,LA,704637,8526,57081,845,647556,7681,3199,0,,737,0,,,79,,42225,B
20200629,MA,842287,6493,108768,101,733519,6392,8095,35,11345,762,26,138,,79,,93157,A+
20200629,MD,529313,9840,67254,477,462059,9363,3175,7,10822,447,29,160,,,,4979,A
20200629,ME,93523,28,3219,28,90304,0,105,1,347,31,1,8,,4,,2623,A
20200629,MI,1029375,12696,70223,277,959152,12419,6161,3,,557,0,193,,106,,51099,A+
20200629,MN,592955,7538,35861,312,557094,7226,1470,10,4031,278,21,140,1249,,,31225,A
20200629,MO,367406,6233,21043,468,346363,5765,998,1,,599,0,,,,,,B
20200629,MP,8217,0,30,0,8187,0,2,0,,,0,,,,,19,D
20200629,MS,283522,3334,26567,675,256955,2659,1059,20,3115,719,13,158,,93,,19388,A
20200629,MT,88743,6269,919,56,87824,6213,22,0,100,13,3,,,,,609,C
20200629,NC,886305,14400,63484,1342,822821,13058,1325,3,,843,0,,,,,45538,A
20200629,ND,105691,1766,3539,44,102152,1722,77,0,227,25,1,,,,,3163,D
20200629,NE,175272,2474,18899,124,156373,2350,267,0,1316,117,1,,,,,13322,B
20200629,NH,118298,2189,5760,43,112538,2146,367,0,565,34,3,,162,,,4435,B
20200629,NJ,1403984,16151,171272,90,1232712,16061,14992,17,19847,978,6,225,,185,,30163,A+
20200629,NM,331048,8089,11809,190,319239,7899,492,1,1865,114,14,,,,,5264,B
20200629,NV,273017,5437,17894,734,255123,4703,504,4,,555,0,124,,65,,689,A+
20200629,NY,3862913,46428,392930,391,3469983,46037,24842,7,89995,853,0,216,,136,,70435,A
20200629,OH,774382,17617,51046,737,723336,16880,2818,11,7746,669,65,245,1961,115,,,B
20200629,OK,326193,228,13172,228,313021,0,385,0,1489,329,33,134,,,,9587,A+
20200629,OR,235133,7263,8485,144,226648,7119,204,2,1025,151,3,44,,25,,2700,A+
20200629,PA,752889,9907,85988,492,666901,9415,6614,35,,635,0,,,111,,67070,A+
20200629,PR,199936,79467,7250,61,192686,79406,153,0,,104,0,8,,1,,,C
20200629,RI,153069,1356,16871,36,136198,1320,946,19,1995,73,11,15,,14,,1627,A+
20200629,SC,369305,9503,34644,1324,334661,8179,720,4,2622,1032,0,,,,,13456,A
20200629,SD,79457,564,6716,35,72741,529,91,0,657,70,5,,,,,5818,B
20200629,TN,777206,28653,42297,2125,734909,26528,592,8,2599,839,35,,,,,26962,B
20200629,TX,1819189,43970,153011,4283,1666178,39687,2403,10,,5913,0,,,,,81335,B
20200629,UT,333905,5456,21664,564,312241,4892,168,1,1417,254,21,80,394,,170,12205,A+
20200629,VA,636372,8044,62189,453,574183,7591,1740,8,8823,796,0,225,,101,,8023,A+
20200629,VI,2827,0,81,0,2746,0,6,0,,,0,,,,,71,C
20200629,VT,64993,1128,1208,6,63785,1122,56,0,,13,0,,,,,949,B
20200629,WA,534443,8641,31752,348,502691,8293,1310,0,4275,270,35,,,52,,,B
20200629,WI,558392,5938,31033,326,527359,5612,784,7,3407,237,14,90,747,,,22217,A+
20200629,WV,169655,3147,2870,53,166785,3094,93,0,,28,0,5,,3,,2196,B
20200629,WY,31856,33,1450,33,30406,0,20,0,112,7,0,,,,,1070,B
20200628,AK,108300,2719,883,29,107417,2690,14,0,,12,0,,,1,,521,A
20200628,AL,386280,2254,35441,358,350839,1896,919,0,2703,655,6,,790,,454,18866,B
20200628,AR,291222,7257,19310,570,271912,6687,259,10,1373,278,36,,,63,210,13270,A
20200628,AS,696,0,0,0,696,0,0,0,,,0,,,,,,C
20200628,AZ,509896,15149,73908,3857,435988,11292,1588,9,4617,2691,22,666,,475,,8926,A+
20200628,CA,3955952,93642,211243,4810,3744709,88832,5905,33,,5956,0,1602,,,,,B
20200628,CO,313711,6128,32022,226,281689,5902,1482,0,5399,235,7,,,,,4442,A
20200628,CT,438623,9075,46303,97,392320,8978,4316,5,10268,103,0,,,,,8053,B
20200628,DC,93132,3861,10248,32,82884,3829,550,2,,126,0,34,,27,,1199,A+
20200628,DE,106346,2084,11226,135,95120,1949,507,0,,78,0,14,,,,6665,A+
20200628,FL,1881897,52372,141075,8530,1740822,43842,3518,29,14540,,108,,,,,,A
20200628,GA,806938,17125,77210,2225,729728,14900,2778,2,10711,1236,22,,2268,,,,A
20200628,GU,12378,227,248,0,12130,227,5,0,,1,0,,,,,179,B
20200628,HI,75478,1177,872,6,74606,1171,18,1,110,,1,,,,,714,D
20200628,IA,295915,6163,28489,477,267426,5686,705,1,,118,0,36,,18,,17620,A+
20200628,ID,86345,2289,5319,171,81026,2118,91,1,312,48,3,18,111,,,3898,A
20200628,IL,1546031,23789,142776,646,1403255,23143,7089,15,,1464,0,373,,193,,,A
20200628,IN,470535,7518,44930,355,425605,7163,2619,3,7003,617,21,266,1468,86,,33935,A+
20200628,KS,167859,0,13538,0,154321,0,264,0,1128,,0,,356,,152,779,A
20200628,KY,358491,7737,15232,373,343259,7364,558,5,2590,386,1,68,996,,,3730,B
20200628,LA,696111,18105,56236,1467,639875,16638,3199,9,,715,0,,,76,,39792,B
20200628,MA,835794,9452,108667,224,727127,9228,8060,19,11319,748,9,134,,81,,93157,A+
20200628,MD,519473,5657,66777,327,452696,5330,3168,11,10793,446,42,158,,,,4976,A
20200628,ME,93495,1563,3191,37,90304,1526,104,0,346,31,1,10,,4,,2577,A
20200628,MI,1016679,15858,69946,267,946733,15591,6158,5,,557,0,193,,106,,51099,A+
20200628,MN,585417,16510,35549,516,549868,15994,1460,8,4010,288,24,143,1241,,,30809,A
20200628,MO,361173,5883,20575,314,340598,5569,997,1,,412,0,,,,,,B
20200628,MP,8217,0,30,0,8187,0,2,0,,,0,,,,,19,D
20200628,MS,280188,2867,25892,361,254296,2506,1039,4,3102,676,24,149,,88,,17242,A
20200628,MT,82474,1227,863,11,81611,1216,22,0,97,11,2,,,,,604,C
20200628,NC,871905,16774,62142,1605,809763,15169,1322,10,,890,0,,,,,36921,A
20200628,ND,103925,1406,3495,37,100430,1369,77,0,226,24,1,,,,,3139,D
20200628,NE,172798,4200,18775,251,154023,3949,267,1,1315,123,3,,,,,13053,B
20200628,NH,116109,1341,5717,46,110392,1295,367,2,562,35,1,,162,,,4401,B
20200628,NJ,1387833,20583,171182,309,1216651,20274,14975,27,19841,1014,18,223,,187,,30092,A+
20200628,NM,322959,2321,11619,211,311340,2110,491,2,1851,122,23,,,,,5251,B
20200628,NV,267580,4554,17160,821,250420,3733,500,0,,511,0,122,,59,,684,A+
20200628,NY,3816485,61906,392539,616,3423946,61290,24835,5,89995,869,0,229,,167,,70010,A
20200628,OH,756765,11926,50309,854,706456,11072,2807,3,7681,661,57,182,1946,101,,,B
20200628,OK,325965,302,12944,302,313021,0,385,1,1456,329,16,134,,,,9397,A+
20200628,OR,227870,247,8341,247,219529,0,202,0,1022,149,0,53,,35,,2649,A+
20200628,PA,742982,23901,85496,1126,657486,22775,6579,0,,648,0,,,121,,66686,A+
20200628,PR,120469,123,7189,123,113280,0,153,1,,99,0,8,,5,,,C
20200628,RI,151713,600,16835,22,134878,578,927,0,1984,91,0,16,,15,,1600,A+
20200628,SC,359802,8638,33320,1381,326482,7257,716,5,2622,954,0,,,,,13456,A
20200628,SD,78893,793,6681,55,72212,738,91,0,652,75,7,,,,,5752,B
20200628,TN,748553,0,40172,0,708381,0,584,0,2564,800,0,,,,,26159,B
20200628,TX,1775219,52393,148728,5357,1626491,47036,2393,27,,5497,0,,,,,79974,B
20200628,UT,328449,5647,21100,472,307349,5175,167,0,1396,289,31,83,389,,167,11931,A+
20200628,VA,628328,10402,61736,489,566592,9913,1732,8,8823,818,36,235,,107,,8005,A+
20200628,VI,2827,0,81,0,2746,0,6,0,,,0,,,,,71,C
20200628,VT,63865,1142,1202,2,62663,1140,56,0,,15,0,,,,,946,B
20200628,WA,525802,11374,31404,549,494398,10825,1310,6,4240,304,46,,,58,,,B
20200628,WI,552454,6504,30707,480,521747,6024,777,0,3393,239,11,89,746,,,21953,A+
20200628,WV,166508,1853,2817,56,163691,1797,93,0,,32,0,10,,4,,2062,B
20200628,WY,31823,25,1417,25,30406,0,20,0,112,5,1,,,,,1057,B
20200627,AK,105581,3789,854,18,104727,3771,14,0,,11,0,,,1,,521,A
20200627,AL,384026,5703,35083,900,348943,4803,919,12,2697,655,44,,789,,453,18866,B
20200627,AR,283965,6585,18740,678,265225,5907,249,9,1337,284,37,,,63,206,12784,A
20200627,AS,696,0,0,0,696,0,0,0,,,0,,,,,,C
20200627,AZ,494747,14924,70051,3503,424696,11421,1579,44,4595,2577,81,657,,433,,8659,A+
20200627,CA,3862310,90996,206433,5972,3655877,85024,5872,60,,5790,0,1562,,,,,B
20200627,CO,307583,5006,31796,317,275787,4689,1482,7,5392,226,6,,,,,4430,A
20200627,CT,429548,12686,46206,147,383342,12539,4311,4,10268,106,0,,,,,8053,B
20200627,DC,89271,1148,10216,31,79055,1117,548,2,,136,0,43,,26,,1194,A+
20200627,DE,104262,2162,11091,74,93171,2088,507,0,,83,0,15,,,,6665,A+
20200627,FL,1829525,60640,132545,9585,1696980,51055,3489,25,14432,,151,,,,,,A
20200627,GA,789813,18785,74985,1990,714828,16795,2776,6,10689,1178,84,,2261,,,,A
20200627,GU,12151,259,248,0,11903,259,5,0,,1,0,,,,,179,B
20200627,HI,74301,1296,866,16,73435,1280,17,0,109,,0,,,,,705,D
20200627,IA,289752,6109,28012,326,261740,5783,704,0,,131,0,40,,22,,17467,A+
20200627,ID,84056,1686,5148,283,78908,1403,90,0,309,42,6,19,108,,,3827,A
20200627,IL,1522242,30237,142130,786,1380112,29451,7074,26,,1516,0,400,,225,,,A
20200627,IN,463017,9127,44575,435,418442,8692,2616,21,6982,595,38,257,1461,82,,33725,A+
20200627,KS,167859,0,13538,0,154321,0,264,0,1128,,0,,356,,152,779,A
20200627,KY,350754,0,14859,0,335895,0,553,0,2589,387,0,74,996,,,3730,B
20200627,LA,678006,0,54769,0,623237,0,3190,0,,700,0,,,73,,39792,B
20200627,MA,826342,12257,108443,373,717899,11884,8041,28,11310,769,19,143,,90,,93157,A+
20200627,MD,513816,7419,66450,335,447366,7084,3157,15,10751,478,26,181,,,,4935,A
20200627,ME,91932,2078,3154,52,88778,2026,104,1,345,24,2,7,,5,,2566,A
20200627,MI,1000821,19115,69679,350,931142,18765,6153,19,,557,0,193,,106,,51099,A+
20200627,MN,568907,11629,35033,417,533874,11212,1452,6,3986,300,20,155,1233,,,30401,A
20200627,MO,355290,6672,20261,347,335029,6325,996,6,,680,0,,,66,,,B
20200627,MP,8217,0,30,0,8187,0,2,0,,,0,,,,,19,D
20200627,MS,277321,5427,25531,465,251790,4962,1035,13,3078,731,34,169,,90,,17242,A
20200627,MT,81247,1086,852,23,80395,1063,22,0,95,9,0,,,,,604,C
20200627,NC,855131,18406,60537,1719,794594,16687,1312,9,,888,0,,,,,36921,A
20200627,ND,102519,1633,3458,37,99061,1596,77,0,225,23,3,,,,,3119,D
20200627,NE,168598,3596,18524,178,150074,3418,266,6,1312,125,18,,,,,12698,B
20200627,NH,114768,0,5671,0,109097,0,365,0,561,32,0,,161,,,4381,B
20200627,NJ,1367250,20578,170873,289,1196377,20289,14948,34,19823,1103,71,236,,200,,29967,A+
20200627,NM,320638,5968,11408,216,309230,5752,489,4,1828,128,17,,,,,5149,B
20200627,NV,263026,4364,16339,1099,246687,3265,500,2,,503,0,117,,66,,684,A+
20200627,NY,3754579,73262,391923,703,3362656,72559,24830,16,89995,908,0,230,,167,,70010,A
20200627,OH,744839,23287,49455,817,695384,22470,2804,16,7624,561,54,190,1916,106,,,B
20200627,OK,325663,14886,12642,299,313021,14587,384,7,1440,329,47,134,,,,9155,A+
20200627,OR,227623,10755,8094,276,219529,10479,202,0,1022,149,0,53,,35,,2649,A+
20200627,PA,719081,0,84370,0,634711,0,6579,0,,651,0,,,126,,65808,A+
20200627,PR,120346,144,7066,144,113280,0,152,1,,105,0,10,,5,,,C
20200627,RI,151113,1234,16813,36,134300,1198,927,0,1984,91,0,16,,15,,1600,A+
20200627,SC,351164,16493,31939,1604,319225,14889,711,17,2622,908,0,,,,,13456,A
20200627,SD,78100,1085,6626,91,71474,994,91,3,645,73,6,,,,,5717,B
20200627,TN,748553,6521,40172,728,708381,5793,584,7,2564,705,66,,,,,26159,B
20200627,TX,1722826,25492,143371,5747,1579455,19745,2366,42,,5523,0,,,,,78248,B
20200627,UT,322802,5234,20628,578,302174,4656,167,1,1365,287,44,77,388,,166,11658,A+
20200627,VA,617926,11463,61247,677,556679,10786,1724,24,8787,819,65,234,,103,,7968,A+
20200627,VI,2827,41,81,0,2746,41,6,0,,,0,,,,,71,C
20200627,VT,62723,1134,1200,2,61523,1132,56,0,,14,0,,,,,946,B
20200627,WA,514428,8633,30855,488,483573,8145,1304,4,4194,305,88,,,50,,,B
20200627,WI,545950,9114,30227,559,515723,8555,777,11,3382,249,31,93,746,,,21606,A+
20200627,WV,164655,2698,2761,49,161894,2649,93,1,,33,0,10,,4,,2042,B
20200627,WY,31798,24,1392,24,30406,0,20,0,111,5,-1,,,,,1054,B
20200626,AK,101792,2340,836,20,100956,2320,14,2,,12,0,,,2,,519,A
20200626,AL,378323,8865,34183,977,344140,7888,907,11,2653,658,41,,772,,450,18866,B
20200626,AR,277380,0,18062,0,259318,0,240,0,1300,284,55,,,61,203,12127,A
20200626,AS,696,0,0,0,696,0,0,0,,,0,,,,,,C
20200626,AZ,479823,15627,66548,3518,413275,12109,1535,45,4514,2110,108,581,,312,,8389,A+
20200626,CA,3771314,76969,200461,4890,3570853,72079,5812,79,,5639,0,1570,,,,,B
20200626,CO,302577,6512,31479,324,271098,6188,1475,18,5386,247,11,,,,,4412,A
20200626,CT,416862,7919,46059,65,370803,7854,4307,9,10268,127,0,,,,,8053,B
20200626,DC,88123,1392,10185,26,77938,1366,546,3,,147,0,48,,29,,1186,A+
20200626,DE,102100,1108,11017,37,91083,1071,507,0,,78,0,,,,,6661,A
20200626,FL,1768885,48241,122960,8942,1645925,39299,3464,41,14281,,213,,,,,,A
20200626,GA,771028,13104,72995,1900,698033,11204,2770,25,10605,1184,148,,2244,,,,A
20200626,GU,11892,474,248,3,11644,471,5,0,,1,0,,,,,179,B
20200626,HI,73005,1070,850,15,72155,1055,17,0,109,,4,,,,,696,D
20200626,IA,283643,6589,27686,489,255957,6100,704,9,,141,0,42,,24,,17313,A+
20200626,ID,82370,1831,4865,220,77505,1611,90,0,303,48,3,20,106,,,3712,A
20200626,IL,1492005,30478,141344,910,1350661,29568,7048,34,,1516,0,400,,225,,,A
20200626,IN,453890,9638,44140,485,409750,9153,2595,9,6944,692,32,281,1458,94,,33396,A+
20200626,KS,167859,6154,13538,568,154321,5586,264,3,1128,,46,,356,,152,779,A
20200626,KY,350754,7872,14859,242,335895,7630,553,7,2589,387,5,74,996,,,3730,B
20200626,LA,678006,17341,54769,1354,623237,15987,3190,26,,700,0,,,73,,39792,B
20200626,MA,814085,8629,108070,233,706015,8396,8013,50,11291,791,39,156,,99,,93157,A+
20200626,MD,506397,7438,66115,338,440282,7100,3142,13,10725,487,42,190,,,,4903,A
20200626,ME,89854,2256,3102,32,86752,2224,103,0,343,28,0,9,,6,,2542,A
20200626,MI,981706,18867,69329,340,912377,18527,6134,1,,557,0,193,,106,,49290,A+
20200626,MN,557278,14582,34616,493,522662,14089,1446,5,3966,335,23,157,1221,,,30008,A
20200626,MO,348618,6970,19914,493,328704,6477,990,8,,600,0,,,66,,,B
20200626,MP,8217,0,30,0,8187,0,2,0,,,0,,,,,19,D
20200626,MS,271894,5897,25066,550,246828,5347,1022,6,3044,769,46,153,,90,,17242,A
20200626,MT,80161,1829,829,26,79332,1803,22,1,95,14,2,,,,,589,C
20200626,NC,836725,25447,58818,1635,777907,23812,1303,19,,892,0,,,,,36921,A
20200626,ND,100886,1442,3421,28,97465,1414,77,1,222,23,0,,,,,3090,D
20200626,NE,165002,1832,18346,125,146656,1707,260,3,1294,126,26,,,,,12314,B
20200626,NH,114768,3202,5671,73,109097,3129,365,18,561,32,3,,161,,,4381,B
20200626,NJ,1346672,25762,170584,388,1176088,25374,14914,42,19752,1118,84,234,,206,,29855,A+
20200626,NM,314670,6565,11192,202,303478,6363,485,5,1811,135,18,,,,,5047,B
20200626,NV,258662,3112,15240,381,243422,2731,498,3,,471,0,118,,59,,684,A+
20200626,NY,3681317,61723,391220,805,3290097,60918,24814,14,89995,951,0,244,,167,,70010,A
20200626,OH,721552,21922,48638,987,672914,20935,2788,16,7570,624,68,205,1904,116,,,B
20200626,OK,310777,5812,12343,395,298434,5417,377,2,1393,308,57,126,,,,8817,A+
20200626,OR,216868,250,7818,250,209050,0,202,5,1022,149,10,53,,35,,2649,A+
20200626,PA,719081,14280,84370,600,634711,13680,6579,22,,661,0,,,131,,65808,A+
20200626,PR,120202,45,6922,45,113280,0,151,0,,89,0,9,,7,,,C
20200626,RI,149879,1383,16777,69,133102,1314,927,7,1984,91,3,16,,15,,1600,A+
20200626,SC,334671,1313,30335,1313,304336,0,694,1,2622,906,245,,,,,13456,A
20200626,SD,77015,1161,6535,56,70480,1105,88,1,639,79,7,,,,,5652,B
20200626,TN,742032,14483,39444,1410,702588,13073,577,10,2498,741,67,,,,,25753,B
20200626,TX,1697334,37994,137624,5707,1559710,32287,2324,28,,5102,0,,,,,76282,B
20200626,UT,317568,5514,20050,676,297518,4838,166,2,1321,238,31,80,375,,161,11097,A+
20200626,VA,606463,13497,60570,624,545893,12873,1700,25,8722,854,50,219,,99,,7868,A+
20200626,VI,2786,52,81,1,2705,51,6,0,,,0,,,,,67,C
20200626,VT,61589,880,1198,7,60391,873,56,0,,14,0,,,,,941,B
20200626,WA,505795,10297,30367,498,475428,9799,1300,7,4106,272,13,,,49,,,B
20200626,WI,536836,9170,29668,563,507168,8607,766,0,3351,262,25,95,741,,,21174,A+
20200626,WV,161957,3253,2712,51,159245,3202,92,0,,33,0,10,,4,,1907,B
20200626,WY,31774,1579,1368,42,30406,1537,20,0,112,5,1,,,,,1033,B
20200625,AK,99452,3356,816,24,98636,3332,12,0,,14,0,,,2,,513,A
20200625,AL,369458,10699,33206,1142,336252,9557,896,5,2612,693,45,,761,,447,18866,B
20200625,AR,277380,5514,18062,687,259318,4827,240,0,1245,284,31,,,61,194,12127,A
20200625,AS,696,522,0,0,696,522,0,0,,,0,,,,,,C
20200625,AZ,464196,15008,63030,3056,401166,11952,1490,27,4406,2453,93,611,,415,,8139,A+
20200625,CA,3694345,101446,195571,5349,3498774,96097,5733,101,,5522,0,1523,,,,,B
20200625,CO,296065,5231,31155,262,264910,4969,1457,2,5375,247,9,,,,,4392,A
20200625,CT,408943,6593,45994,81,362949,6512,4298,11,10268,122,169,,,,,8053,B
20200625,DC,86731,2558,10159,31,76572,2527,543,2,,157,0,53,,34,,1182,A+
20200625,DE,100992,2791,10980,91,90012,2700,507,2,,93,0,,,,,6646,A
20200625,FL,1720644,52302,114018,5004,1606626,47298,3423,46,14068,,203,,,,,,A
20200625,GA,757924,14690,71095,1714,686829,12976,2745,47,10457,1135,144,,2222,,,,A
20200625,GU,11418,380,245,14,11173,366,5,0,,0,0,0,,0,,174,A
20200625,HI,71935,1396,835,16,71100,1380,17,0,105,,1,,,,,686,D
20200625,IA,277054,7095,27197,492,249857,6603,695,3,,137,0,42,,26,,17017,A+
20200625,ID,80539,2704,4645,243,75894,2461,90,1,300,45,2,14,106,,,3610,A
20200625,IL,1461527,31686,140434,894,1321093,30792,7014,40,,1626,0,399,,216,,,A
20200625,IN,444252,12369,43655,515,400597,11854,2586,8,6912,723,29,276,1452,91,,33036,A+
20200625,KS,161705,0,12970,0,148735,0,261,0,1082,,0,,348,,150,747,A
20200625,KY,342882,7180,14617,254,328265,6926,546,8,2584,377,10,79,994,,,3719,B
20200625,LA,660665,12160,53415,938,607250,11222,3164,12,,653,0,,,77,,39792,B
20200625,MA,805456,10384,107837,226,697619,10158,7963,25,11252,822,33,174,,101,,93157,A+
20200625,MD,498959,8502,65777,440,433182,8062,3129,21,10683,511,35,209,,,,4874,A
20200625,ME,87598,2408,3070,53,84528,2355,103,0,343,25,4,10,,7,,2512,A
20200625,MI,962839,18034,68989,434,893850,17600,6133,19,,557,0,193,,115,,49290,A+
20200625,MN,542696,13053,34123,360,508573,12693,1441,9,3943,336,46,162,1218,,,29854,A
20200625,MO,341648,14624,19421,553,322227,14071,982,7,,546,0,,,66,,,B
20200625,MP,8217,0,30,0,8187,0,2,0,,,0,,,,,19,D
20200625,MS,265997,4336,24516,1092,241481,3244,1016,5,2998,755,52,157,,94,,17242,A
20200625,MT,78332,3266,803,37,77529,3229,21,0,93,15,0,,,,,572,C
20200625,NC,811278,19993,57183,1009,754095,18984,1284,18,,891,0,,,,,36921,A
20200625,ND,99444,755,3393,31,96051,724,76,2,222,25,3,,,,,3064,D
20200625,NE,163170,1869,18221,129,144949,1740,257,1,1268,131,11,,,,,12099,B
20200625,NH,111566,1513,5598,27,105968,1486,347,4,558,49,0,,160,,,4358,B
20200625,NJ,1320910,21265,170196,304,1150714,20961,14872,1877,19668,1182,70,252,,210,,29740,A+
20200625,NM,308105,6022,10990,152,297115,5870,480,4,1793,149,17,,,,,4984,B
20200625,NV,255550,3163,14859,497,240691,2666,495,1,,467,0,98,,57,,682,A+
20200625,NY,3619594,67642,390415,749,3229179,66893,24800,18,89995,996,0,270,,167,,70010,A
20200625,OH,699630,18943,47651,892,651979,18051,2772,17,7502,624,55,206,1897,121,,,B
20200625,OK,304965,6687,11948,438,293017,6249,375,3,1336,277,17,87,,,,8507,A+
20200625,OR,216618,2610,7568,124,209050,2486,197,2,1012,189,6,60,,29,,2649,A+
20200625,PA,704801,13393,83770,579,621031,12814,6557,39,,704,0,,,142,,65340,A+
20200625,PR,120157,57,6877,57,113280,0,151,2,,85,0,12,,4,,,C
20200625,RI,148496,1451,16708,45,131788,1406,920,8,1981,103,14,18,,17,,1588,A+
20200625,SC,333358,15150,29022,1125,304336,14025,693,10,2377,881,0,,,,,12317,A
20200625,SD,75854,777,6479,60,69375,717,87,3,632,79,3,,,,,5592,B
20200625,TN,727549,9245,38034,799,689515,8446,567,11,2431,741,45,,,,,25280,B
20200625,TX,1659340,29082,131917,5996,1527423,23086,2296,47,,4739,0,,,,,74496,B
20200625,UT,312054,7316,19374,590,292680,6726,164,1,1290,230,34,79,365,,160,10642,A+
20200625,VA,592966,16395,59946,432,533020,15963,1675,14,8672,854,21,237,,104,,7818,A+
20200625,VI,2734,63,80,2,2654,61,6,0,,,0,,,,,64,C
20200625,VT,60709,849,1191,7,59518,842,56,0,,15,0,,,,,938,B
20200625,WA,495498,8439,29869,483,465629,7956,1293,9,4093,304,26,,,56,,,B
20200625,WI,527666,11222,29105,464,498561,10758,766,9,3326,249,27,93,734,,,20557,A+
20200625,WV,158704,1656,2661,32,156043,1624,92,0,,24,0,5,,2,,1858,B
20200625,WY,30195,47,1326,47,28869,0,20,0,111,7,2,,,,,996,B
20200624,AK,96096,3149,792,14,95304,3135,12,0,,16,0,,,2,,507,A
20200624,AL,358759,4721,32064,967,326695,3754,891,27,2567,667,46,,749,,441,18866,B
20200624,AR,271866,7374,17375,697,254491,6677,240,3,1214,267,26,,,58,189,11568,B
20200624,AS,174,0,0,0,174,0,0,0,,,0,,,,,,C
20200624,AZ,449188,8670,59974,1795,389214,6875,1463,79,4313,2270,58,581,,407,,7936,A+
20200624,CA,3592899,95970,190222,7149,3402677,88821,5632,52,,5399,0,1487,,,,,B
20200624,CO,290834,2958,30893,188,259941,2770,1455,17,5366,238,23,,,,,4370,A
20200624,CT,402350,-1594,45913,14,356437,-1608,4287,10,10099,124,0,,,,,7842,B
20200624,DC,84173,871,10128,34,74045,837,541,4,,167,0,58,,36,,1182,A+
20200624,DE,98201,665,10889,42,87312,623,505,1,,85,0,,,,,6598,A
20200624,FL,1668342,27590,109014,5511,1559328,22079,3377,44,13865,,251,,,,,,A
20200624,GA,743234,11973,69381,1703,673853,10270,2698,10,10313,1124,190,,2206,,,,A
20200624,GU,11038,387,231,6,10807,381,5,0,,0,0,0,,0,,174,A
20200624,HI,70539,1199,819,3,69720,1196,17,0,104,,5,,,,,673,D
20200624,IA,269959,5256,26705,332,243254,4924,692,4,,140,0,43,,25,,16858,A+
20200624,ID,77835,1671,4402,148,73433,1523,89,0,298,34,5,14,105,,,3484,A
20200624,IL,1429841,29331,139540,715,1290301,28616,6974,63,,1614,0,389,,219,,,A
20200624,IN,431883,5507,43140,269,388743,5238,2578,9,6883,701,30,263,1446,89,,32152,A+
20200624,KS,161705,6692,12970,505,148735,6187,261,2,1082,,26,,348,,150,747,A
20200624,KY,335702,4408,14363,222,321339,4186,538,1,2574,335,18,79,992,,,3706,B
20200624,LA,648505,12566,52477,882,596028,11684,3152,18,,631,0,,,77,,39792,B
20200624,MA,795072,7430,107611,172,687461,7258,7938,48,11219,939,62,181,,98,,91404,A+
20200624,MD,490457,6922,65337,330,425120,6592,3108,16,10648,544,37,213,,,,4810,A
20200624,ME,85190,3483,3017,23,82173,3460,103,1,339,26,0,12,,6,,2490,A
20200624,MI,944805,16137,68555,358,876250,15779,6114,5,,557,0,209,,124,,49290,A+
20200624,MN,529643,9598,33763,294,495880,9304,1432,7,3897,340,37,160,1203,,,29707,A
20200624,MO,327024,9650,18868,725,308156,8925,975,14,,546,0,,,66,,,B
20200624,MP,8217,0,30,0,8187,0,2,0,,,0,,,,,19,D
20200624,MS,261661,7801,23424,526,238237,7275,1011,22,2946,767,31,157,,91,,17242,A
20200624,MT,75066,1143,766,23,74300,1120,21,0,93,17,2,,,,,571,C
20200624,NC,791285,17457,56174,1721,735111,15736,1266,15,,906,0,,,,,36921,A
20200624,ND,98689,1136,3362,42,95327,1094,74,1,219,27,1,,,,,3044,D
20200624,NE,161301,2659,18092,135,143209,2524,256,7,1257,125,23,,,,,12099,B
20200624,NH,110053,1177,5571,13,104482,1164,343,4,558,51,0,,160,,,4316,B
20200624,NJ,1299645,16194,169892,158,1129753,16036,12995,46,19598,1196,86,275,,214,,29627,A+
20200624,NM,302083,4007,10838,144,291245,3863,476,7,1776,141,22,,,,,4874,B
20200624,NV,252387,3861,14362,365,238025,3496,494,2,,439,0,96,,53,,666,A+
20200624,NY,3551952,51144,389666,581,3162286,50563,24782,16,89995,1071,0,290,,228,,69710,A
20200624,OH,680687,10250,46759,632,633928,9618,2755,20,7447,592,68,202,1886,119,,,B
20200624,OK,298278,3221,11510,482,286768,2739,372,1,1319,268,31,90,,,,8144,A+
20200624,OR,214008,3296,7444,170,206564,3126,195,3,1006,185,23,59,,29,,2604,A+
20200624,PA,691408,12305,83191,495,608217,11810,6518,54,,707,0,,,136,,64502,A+
20200624,PR,120100,135,6820,135,113280,0,149,0,,80,0,9,,2,,,C
20200624,RI,147045,1537,16663,51,130382,1486,912,6,1967,104,9,20,,16,,1573,A+
20200624,SC,318208,8957,27897,1284,290311,7673,683,10,2377,832,0,,,,,12317,A
20200624,SD,75077,1091,6419,66,68658,1025,84,1,629,81,5,,,,,5554,B
20200624,TN,718304,12885,37235,932,681069,11953,556,14,2386,696,50,,,,,24693,B
20200624,TX,1630258,32968,125921,5551,1504337,27417,2249,29,,4389,0,,,,,72898,B
20200624,UT,304738,2462,18784,484,285954,1978,163,0,1256,245,30,77,355,,154,10334,A+
20200624,VA,576571,8194,59514,520,517057,7674,1661,16,8651,886,79,235,,107,,7765,A+
20200624,VI,2671,51,78,2,2593,49,6,0,,,0,,,,,64,C
20200624,VT,59860,532,1184,20,58676,512,56,0,,13,0,,,,,930,B
20200624,WA,487059,9855,29386,516,457673,9339,1284,8,4067,234,5,,,44,,,B
20200624,WI,516444,10104,28641,466,487803,9638,757,7,3299,239,31,89,723,,,20121,A+
20200624,WV,157048,2720,2629,47,154419,2673,92,0,,24,0,5,,2,,1855,B
20200624,WY,30148,1409,1279,25,28869,1384,20,0,109,7,0,,,,,966,B
20200623,AK,92947,2123,778,17,92169,2106,12,0,,14,0,,,1,,502,A
20200623,AL,354038,4928,31097,643,322941,4285,864,23,2521,680,50,,737,,430,15974,B
20200623,AR,264492,8153,16678,595,247814,7558,237,10,1188,248,24,,,57,186,11220,A
20200623,AS,174,0,0,0,174,0,0,0,,,0,,,,,,C
20200623,AZ,440518,10728,58179,3593,382339,7135,1384,42,4255,2136,0,614,,386,,7746,A+
20200623,CA,3496929,85243,183073,5019,3313856,80224,5580,65,,5065,0,1421,,,,,B
20200623,CO,287876,5104,30705,166,257171,4938,1438,9,5343,249,16,,,,,4342,A
20200623,CT,403944,6392,45899,117,358045,6275,4277,14,10099,138,0,,,,,7842,B
20200623,DC,83302,1298,10094,36,73208,1262,537,2,,171,0,61,,40,,1182,A+
20200623,DE,97536,813,10847,27,86689,786,504,0,,91,0,,,,,6554,A
20200623,FL,1640752,23265,103503,3286,1537249,19979,3333,67,13614,,207,,,,,,A
20200623,GA,731261,23235,67678,1750,663583,21485,2688,40,10123,1056,170,,2174,,,,A
20200623,GU,10651,247,225,1,10426,246,5,0,,0,0,0,,0,,174,A
20200623,HI,69340,629,816,2,68524,627,17,0,99,,2,,,,,669,D
20200623,IA,264703,6071,26373,322,238330,5749,688,2,,163,0,47,,26,,16579,A+
20200623,ID,76164,3196,4254,248,71910,2948,89,0,293,39,10,14,102,,,3405,A
20200623,IL,1400510,20507,138825,601,1261685,19906,6911,36,,1648,0,424,,236,,,A
20200623,IN,426376,7460,42871,238,383505,7222,2569,16,6853,736,34,297,1447,110,,32152,A+
20200623,KS,155013,0,12465,0,142548,0,259,0,1056,,0,,342,,149,722,A
20200623,KY,331294,9262,14141,302,317153,8960,537,11,2556,376,24,70,988,,,3591,B
20200623,LA,635939,17875,51595,1356,584344,16519,3134,17,,646,0,,,83,,39792,B
20200623,MA,787642,7579,107439,229,680203,7350,7890,16,11157,953,63,181,,112,,91404,A+
20200623,MD,483535,8810,65007,404,418528,8406,3092,18,10611,561,39,212,,,,4797,A
20200623,ME,81707,703,2994,23,78713,680,102,0,339,24,3,12,,6,,2443,B
20200623,MI,928668,10651,68197,240,860471,10411,6109,12,,557,0,209,,99,,49290,A+
20200623,MN,520045,6908,33469,242,486576,6666,1425,9,3860,339,30,158,1191,,,29399,A
20200623,MO,317374,0,18143,0,299231,0,961,0,,595,0,,,66,,,B
20200623,MP,8217,48,30,0,8187,48,2,0,,,0,,,,,19,D
20200623,MS,253860,611,22898,611,230962,0,989,11,2915,664,34,151,,88,,17242,A
20200623,MT,73923,2618,743,3,73180,2615,21,0,91,15,1,,,,,566,C
20200623,NC,773828,16483,54453,848,719375,15635,1251,28,,915,0,,,,,36921,A
20200623,ND,97553,100,3320,7,94233,93,73,1,218,28,0,,,,,3008,D
20200623,NE,158642,2134,17957,147,140685,1987,249,5,1234,135,22,,,,,11980,D
20200623,NH,108876,14,5558,14,103318,0,339,0,558,54,5,,160,,,4290,B
20200623,NJ,1283451,16052,169734,319,1113717,15733,12949,54,19512,1092,111,307,,216,,29517,A+
20200623,NM,298076,4645,10694,129,287382,4516,469,0,1754,139,8,,,,,4742,C
20200623,NV,248526,4461,13997,462,234529,3999,492,0,,389,0,100,,50,,658,A+
20200623,NY,3500808,48709,389085,597,3111723,48112,24766,27,89995,1104,0,302,,228,,69710,A
20200623,OH,670437,10836,46127,590,624310,10246,2735,31,7379,570,87,205,1876,126,,,B
20200623,OK,295057,12399,11028,295,284029,12104,371,2,1288,265,20,111,,,,7888,A+
20200623,OR,210712,4084,7274,191,203438,3893,192,0,983,184,14,58,,28,,2604,A+
20200623,PA,679103,11255,82696,510,596407,10745,6464,38,,738,0,,,151,,64502,A+
20200623,PR,119965,121,6685,121,113280,0,149,0,,77,0,9,,2,,,C
20200623,RI,145508,1676,16612,77,128896,1599,906,3,1958,105,8,19,,17,,1562,A+
20200623,SC,309251,5371,26613,912,282638,4459,673,14,2377,824,83,,,,,12317,A
20200623,SD,73986,657,6353,27,67633,630,83,2,624,85,8,,,,,5497,B
20200623,TN,705419,5314,36303,750,669116,4564,542,11,2336,721,35,,,,,24068,B
20200623,TX,1597290,48281,120370,5489,1476920,42792,2220,28,,4092,0,,,,,70714,B
20200623,UT,302276,2964,18300,394,283976,2570,163,5,1226,214,34,77,344,,153,10057,A
20200623,VA,568377,10254,58994,529,509383,9725,1645,25,8572,847,61,245,,126,,7725,A+
20200623,VI,2620,42,76,0,2544,42,6,0,,,0,,,,,64,C
20200623,VT,59328,721,1164,1,58164,720,56,0,,19,0,,,,,927,B
20200623,WA,477204,2266,28870,190,448334,2076,1276,6,4062,204,13,,,37,,,B
20200623,WI,506340,11828,28175,297,478165,11531,750,5,3268,240,37,93,716,,,19852,A+
20200623,WV,154328,3124,2582,30,151746,3094,92,3,,21,0,5,,2,,1790,B
20200623,WY,28739,1347,1254,24,27485,1323,20,0,109,8,4,,,,,953,C
20200622,AK,90824,2773,761,6,90063,2767,12,0,,13,0,,,1,,491,A
20200622,AL,349110,4432,30454,433,318656,3999,841,2,2471,658,11,,725,,424,15974,B
20200622,AR,256339,14105,16083,941,240256,13164,227,3,1164,237,12,,,61,186,10793,A
20200622,AS,174,0,0,0,174,0,0,0,,,0,,,,,,C
20200622,AZ,429790,10046,54586,2196,375204,7850,1342,3,4255,1992,0,583,,379,,7581,A+
20200622,CA,3411686,92430,178054,4230,3233632,88200,5515,20,,4804,0,1412,,,,,B
20200622,CO,282772,4386,30539,190,252233,4196,1429,0,5327,256,4,,,,,4328,A
20200622,CT,397552,2124,45782,27,351770,2097,4263,3,10099,140,0,,,,,7842,B
20200622,DC,82004,2482,10058,38,71946,2444,535,2,,155,0,50,,34,,1182,A+
20200622,DE,96723,1749,10820,45,85903,1704,504,0,,89,0,,,,,6459,A
20200622,FL,1617487,18191,100217,2926,1517270,15265,3266,12,13407,,82,,,,,,A
20200622,GA,708026,9719,65928,1227,642098,8492,2648,5,9953,1000,116,,2155,,,,A
20200622,GU,10404,394,224,2,10180,392,5,0,,0,0,0,,0,,173,A
20200622,HI,68711,851,814,11,67897,840,17,0,97,,1,,,,,651,D
20200622,IA,258632,1480,26051,88,232581,1392,686,1,,169,0,51,,28,,16240,A+
20200622,ID,72968,0,4006,0,68962,0,89,0,283,41,0,12,101,,,3305,A
20200622,IL,1380003,18219,138224,462,1241779,17757,6875,24,,1628,0,419,,250,,,A
20200622,IN,418916,6996,42633,210,376283,6786,2553,13,6819,756,31,283,1452,108,,31739,A+
20200622,KS,155013,7364,12465,406,142548,6958,259,5,1056,,21,,342,,149,722,A
20200622,KY,322032,4751,13839,89,308193,4662,526,0,2532,349,10,67,987,,,3534,B
20200622,LA,618064,7252,50239,461,567825,6791,3117,12,,630,0,,,77,,39792,B
20200622,MA,780063,6743,107210,149,672853,6594,7874,16,11094,920,9,180,,107,,91404,A+
20200622,MD,474725,5694,64603,297,410122,5397,3074,8,10572,602,28,232,,,,4776,A
20200622,ME,81004,14,2971,14,78033,0,102,0,336,27,0,13,,6,,2409,B
20200622,MI,918017,10591,67957,246,850060,10345,6097,7,,557,0,209,,99,,49290,A+
20200622,MN,513137,8774,33227,307,479910,8467,1416,4,3830,332,33,156,1180,,,29065,A
20200622,MO,317374,2217,18143,140,299231,2077,961,5,,415,0,,,66,,,B
20200622,MP,8169,0,30,0,8139,0,2,0,,,0,,,,,19,D
20200622,MS,253249,14534,22287,1646,230962,12888,978,40,2881,710,114,148,,95,,17242,A
20200622,MT,71305,948,740,23,70565,925,21,1,90,15,1,,,,,548,C
20200622,NC,757345,11570,53605,804,703740,10766,1223,3,,870,0,,,,,36921,A
20200622,ND,97453,1280,3313,25,94140,1255,72,1,218,31,2,,,,,2952,D
20200622,NE,156508,2267,17810,103,138698,2164,244,0,1212,141,0,,,,,11776,D
20200622,NH,108862,2977,5544,26,103318,2951,339,0,553,55,2,,159,,,4275,B
20200622,NJ,1267399,22432,169415,273,1097984,22159,12895,25,19401,1033,134,287,,213,,29522,A+
20200622,NM,293431,0,10565,0,282866,0,469,0,1746,134,0,,,,,4684,C
20200622,NV,244065,2374,13535,330,230530,2044,492,0,,373,0,100,,46,,653,A+
20200622,NY,3452099,56780,388488,552,3063611,56228,24739,14,89995,1122,0,330,,228,,69710,A
20200622,OH,659601,16380,45537,729,614064,15651,2704,4,7292,549,50,217,1852,124,,,B
20200622,OK,282658,218,10733,218,271925,0,369,0,1268,197,25,93,,,,7648,A+
20200622,OR,206628,4017,7083,146,199545,3871,192,2,969,145,23,48,,27,,2588,A+
20200622,PA,667848,10103,82186,456,585662,9647,6426,3,,745,0,,,156,,64105,A+
20200622,PR,119844,39,6564,39,113280,0,149,0,,70,0,10,,3,,,C
20200622,RI,143832,1655,16535,59,127297,1596,903,9,1950,106,28,18,,15,,1554,A+
20200622,SC,303880,1213,25701,1008,278179,205,659,6,2294,731,0,,,,,10790,A
20200622,SD,73329,303,6326,29,67003,274,81,0,616,88,8,,,,,5437,B
20200622,TN,700105,14476,35553,451,664552,14025,531,5,2301,664,10,,,,,23567,B
20200622,TX,1549009,22829,114881,3280,1434128,19549,2192,10,,3711,0,,,,,69190,B
20200622,UT,299312,2917,17906,444,281406,2473,158,0,1192,198,8,67,338,,150,9863,A
20200622,VA,558123,12447,58465,471,499658,11976,1620,9,8511,848,2,240,,132,,7663,A+
20200622,VI,2578,0,76,0,2502,0,6,0,,,0,,,,,64,C
20200622,VT,58607,762,1163,4,57444,758,56,0,,8,0,,,,,926,B
20200622,WA,474938,8869,28680,455,446258,8414,1270,5,4049,205,19,,,42,,,B
20200622,WI,494512,6563,27878,263,466634,6300,745,1,3231,246,11,93,711,,,19543,A+
20200622,WV,151204,615,2552,9,148652,606,89,0,,21,0,5,,2,,1681,B
20200622,WY,27392,33,1230,33,26162,0,20,0,105,8,5,,,,,931,C
20200621,AK,88051,1133,755,12,87296,1121,12,0,,15,0,,,1,,475,A
20200621,AL,344678,5155,30021,472,314657,4683,839,1,2460,593,17,,721,,424,15974,B
20200621,AR,242234,0,15142,0,227092,0,224,0,1152,240,52,,,59,184,10082,A
20200621,AS,174,0,0,0,174,0,0,0,,,0,,,,,,C
20200621,AZ,419744,14464,52390,2592,367354,11872,1339,1,4255,1942,3,556,,361,,7387,A+
20200621,CA,3319256,84844,173824,4515,3145432,80329,5495,71,,4679,0,1366,,,,,B
20200621,CO,278386,5317,30349,162,248037,5155,1429,0,5323,255,5,,,,,4309,A
20200621,CT,395428,3773,45755,40,349673,3733,4260,9,10099,149,0,,,,,7842,B
20200621,DC,79522,1569,10020,36,69502,1533,533,2,,168,0,61,,37,,1172,A+
20200621,DE,94974,2558,10775,94,84199,2464,504,0,,79,0,,,,,6459,A
20200621,FL,1599296,38024,97291,3494,1502005,34530,3254,17,13325,,98,,,,,,A
20200621,GA,698307,3923,64701,892,633606,3031,2643,1,9837,944,0,,2140,,,,A
20200621,GU,10010,0,222,0,9788,0,5,0,,0,0,0,,0,,173,A
20200621,HI,67860,1126,803,14,67057,1112,17,0,96,,0,,,,,644,D
20200621,IA,257152,6945,25963,467,231189,6478,685,4,,170,0,53,,27,,16068,A+
20200621,ID,72968,1772,4006,135,68962,1637,89,0,283,31,4,12,101,,,3305,A
20200621,IL,1361784,23816,137762,658,1224022,23158,6851,22,,1631,0,422,,256,,,A
20200621,IN,411920,10118,42423,362,369497,9756,2540,4,6788,744,33,226,1450,124,,31302,A+
20200621,KS,147649,0,12059,0,135590,0,254,0,1035,,0,,338,,146,715,A
20200621,KY,317281,120,13750,120,303531,0,526,2,2522,354,0,62,980,,,3530,B
20200621,LA,610812,5996,49778,393,561034,5603,3105,1,,589,0,,,69,,37017,B
20200621,MA,773320,8383,107061,125,666259,8258,7858,30,11085,927,9,194,,111,,91404,A+
20200621,MD,469031,6751,64306,350,404725,6401,3066,14,10544,608,47,230,,,,4773,A
20200621,ME,80990,1414,2957,19,78033,1395,102,0,336,26,3,11,,5,,2391,B
20200621,MI,907426,12792,67711,166,839715,12626,6090,3,,557,0,209,,99,,49290,A+
20200621,MN,504363,12320,32920,453,471443,11867,1412,8,3797,322,30,160,1163,,,28663,A
20200621,MO,315157,4042,18003,413,297154,3629,956,1,,415,0,,,66,,,B
20200621,MP,8169,0,30,0,8139,0,2,0,,,0,,,,,19,D
20200621,MS,238715,0,20641,0,218074,0,938,0,2767,689,0,156,,98,,15323,A
20200621,MT,70357,827,717,19,69640,808,20,0,89,15,4,,,,,548,C
20200621,NC,745775,14434,52801,1412,692974,13022,1220,8,,845,0,,,,,29219,A
20200621,ND,96173,1942,3288,37,92885,1905,71,0,216,31,3,,,,,2910,D
20200621,NE,154241,2387,17707,116,136534,2271,244,0,1212,140,12,,,,,11565,D
20200621,NH,105885,318,5518,32,100367,286,339,2,551,55,2,,159,,,4244,B
20200621,NJ,1244967,26094,169142,308,1075825,25786,12870,13,19267,1105,0,278,,219,,29450,A+
20200621,NM,293431,8829,10565,305,282866,8524,469,5,1746,134,11,,,,,4684,C
20200621,NV,241691,2728,13205,274,228486,2454,492,1,,370,0,87,,49,,652,A+
20200621,NY,3395319,67526,387936,664,3007383,66862,24725,15,89995,1142,0,332,,237,,69506,A
20200621,OH,643221,13256,44808,546,598413,12710,2700,3,7242,496,41,194,1844,119,,,B
20200621,OK,282440,478,10515,478,271925,0,369,1,1243,197,14,93,,,,7531,A+
20200621,OR,202611,8516,6937,187,195674,8329,190,1,946,154,0,50,,29,,2533,A+
20200621,PA,657745,10018,81730,464,576015,9554,6423,4,,735,0,,,157,,62932,A+
20200621,PR,119805,62,6525,62,113280,0,149,2,,71,0,13,,5,,,C
20200621,RI,142177,650,16476,27,125701,623,894,0,1922,123,0,23,,12,,1515,A+
20200621,SC,302667,6418,24693,907,277974,5511,653,9,2294,692,0,,,,,10790,A
20200621,SD,73026,1111,6297,72,66729,1039,81,0,608,89,10,,,,,5389,B
20200621,TN,685629,10289,35102,656,650527,9633,526,2,2291,605,25,,,,,23067,B
20200621,TX,1526180,62782,111601,3866,1414579,58916,2182,17,,3409,0,,,,,68499,B
20200621,UT,296395,3518,17462,394,278933,3124,158,3,1184,222,23,67,338,,150,9659,A
20200621,VA,545676,14272,57994,551,487682,13721,1611,4,8509,863,22,243,,125,,7646,A+
20200621,VI,2578,12,76,2,2502,10,6,0,,,0,,,,,64,C
20200621,VT,57845,817,1159,12,56686,805,56,0,,11,0,,,,,922,B
20200621,WA,466069,-9082,28225,-455,437844,-8627,1265,10,4030,267,27,,,54,,,B
20200621,WI,487949,6060,27615,289,460334,5771,744,0,3220,242,17,94,710,,,19310,A+
20200621,WV,150589,2193,2543,57,148046,2136,89,1,,23,0,3,,2,,1676,B
20200621,WY,27359,18,1197,18,26162,0,20,0,100,8,2,,,,,909,C
20200620,AK,86918,3287,743,21,86175,3266,12,0,,16,0,,,1,,464,A
20200620,AL,339523,8198,29549,547,309974,7651,838,16,2443,628,27,,717,,418,15974,B
20200620,AR,242234,7462,15142,511,227092,6951,224,10,1100,224,0,,,53,175,10082,B
20200620,AS,174,0,0,0,174,0,0,0,,,0,,,,,,C
20200620,AZ,405280,13064,49798,3109,355482,9955,1338,26,4252,1938,6,546,,368,,7196,A+
20200620,CA,3234412,78710,169309,3893,3065103,74817,5424,64,,4582,0,1332,,,,,B
20200620,CO,273069,8623,30187,286,242882,8337,1429,12,5318,250,10,,,,,4296,A
20200620,CT,391655,11777,45715,158,345940,11619,4251,13,10099,150,0,,,,,7842,B
20200620,DC,77953,4162,9984,32,67969,4130,531,1,,177,0,58,,40,,1166,A+
20200620,DE,92416,1982,10681,70,81735,1912,504,0,,75,0,,,,,6395,A
20200620,FL,1561272,28401,93797,4049,1467475,24352,3237,40,13227,,165,,,,,,A
20200620,GA,694384,24078,63809,1800,630575,22278,2642,6,9837,944,65,,2140,,,,A
20200620,GU,10010,295,222,22,9788,273,5,0,,0,0,0,,0,,173,A
20200620,HI,66734,990,789,27,65945,963,17,0,96,,1,,,,,642,D
20200620,IA,250207,3558,25496,221,224711,3337,681,0,,182,0,58,,30,,15963,A+
20200620,ID,71196,1651,3871,128,67325,1523,89,0,279,28,1,9,101,,,3183,A
20200620,IL,1337968,25965,137104,634,1200864,25331,6829,111,,1696,0,454,,274,,,A
20200620,IN,401802,8915,42061,315,359741,8600,2536,20,6755,768,24,231,1444,113,,31110,A+
20200620,KS,147649,0,12059,0,135590,0,254,0,1035,,0,,338,,146,715,A
20200620,KY,317161,5934,13630,176,303531,5758,524,2,2522,354,28,62,980,,,3530,B
20200620,LA,604816,13907,49385,870,555431,13037,3104,20,,574,0,,,73,,37017,B
20200620,MA,764937,14130,106936,286,658001,13844,7828,28,11076,964,40,200,,118,,91404,A+
20200620,MD,462280,8611,63956,408,398324,8203,3052,22,10497,644,50,238,,,,4745,A
20200620,ME,79576,2415,2938,25,76638,2390,102,0,333,29,5,13,,5,,2380,B
20200620,MI,894634,14706,67545,448,827089,14258,6087,20,,557,0,209,,99,,49290,A+
20200620,MN,492043,16891,32467,436,459576,16455,1404,11,3767,324,19,161,1155,,,28205,A
20200620,MO,311115,4831,17590,389,293525,4442,955,7,,415,0,,,66,,,B
20200620,MP,8169,0,30,0,8139,0,2,0,,,0,,,,,19,D
20200620,MS,238715,0,20641,0,218074,0,938,0,2767,465,0,159,,108,,15323,A
20200620,MT,69530,1108,698,32,68832,1076,20,0,85,10,3,,,,,548,C
20200620,NC,731341,19028,51389,1549,679952,17479,1212,15,,883,0,,,,,29219,A
20200620,ND,94231,1625,3251,25,90980,1600,71,0,213,28,3,,,,,2882,D
20200620,NE,151854,4008,17591,176,134263,3832,244,4,1200,141,34,,,,,11312,D
20200620,NH,105567,1842,5486,36,100081,1806,337,6,549,61,16,,159,,,4209,B
20200620,NJ,1218873,24530,168834,338,1050039,24192,12857,22,19267,1125,0,286,,238,,29318,A+
20200620,NM,284602,4427,10260,107,274342,4320,464,8,1735,147,9,,,,,4512,C
20200620,NV,238963,4603,12931,445,226032,4158,491,0,,370,0,87,,49,,652,A+
20200620,NY,3327793,68830,387272,716,2940521,68114,24710,24,89995,1220,0,335,,237,,69506,A
20200620,OH,629965,13929,44262,531,585703,13398,2697,30,7201,482,34,186,1833,118,,,B
20200620,OK,281962,7384,10037,331,271925,7053,368,1,1229,197,20,93,,,,7414,A+
20200620,OR,194095,178,6750,178,187345,0,189,1,946,154,0,50,,29,,2533,A+
20200620,PA,647727,10509,81266,504,566461,10005,6419,20,,715,0,,,161,,62574,A+
20200620,PR,119743,268,6463,268,113280,0,147,0,,83,0,10,,4,,,C
20200620,RI,141527,717,16449,36,125078,681,894,0,1922,123,0,23,,12,,1515,A+
20200620,SC,296249,7949,23786,1155,272463,6794,644,5,2294,673,0,,,,,10790,A
20200620,SD,71915,722,6225,67,65690,655,81,0,598,91,9,,,,,5335,B
20200620,TN,675340,13651,34446,429,640894,13222,524,9,2266,588,28,,,,,22838,B
20200620,TX,1463398,39484,107735,4430,1355663,35054,2165,25,,3247,0,,,,,67096,B
20200620,UT,292877,5519,17068,643,275809,4876,155,0,1161,232,16,66,333,,149,9390,A
20200620,VA,531404,18993,57443,650,473961,18343,1607,5,8487,880,62,267,,133,,7607,A+
20200620,VI,2566,42,74,0,2492,42,6,0,,,0,,,,,64,C
20200620,VT,57028,1141,1147,3,55881,1138,56,0,,9,0,,,,,920,B
20200620,WA,475151,689,28680,14,446471,675,1255,10,4003,245,44,,,49,,,B
20200620,WI,481889,10225,27326,413,454563,9812,744,14,3203,239,26,90,708,,,18951,A+
20200620,WV,148396,2382,2486,51,145910,2331,88,0,,22,0,6,,2,,1669,B
20200620,WY,27341,-9133,1179,6,26162,-9139,20,0,98,8,0,,,,,896,C
20200619,AK,83631,2446,722,14,82909,2432,12,0,,18,0,,,1,,457,A
20200619,AL,331325,8791,29002,796,302323,7995,822,12,2416,674,43,,710,,415,15974,B
20200619,AR,234772,6338,14631,703,220141,5635,214,6,1100,224,26,,,53,175,9712,B
20200619,AS,174,0,0,0,174,0,0,0,,,0,,,,,,C
20200619,AZ,392216,12484,46689,3246,345527,9238,1312,41,4246,1832,5,519,,362,,7018,A+
20200619,CA,3155702,81172,165416,4317,2990286,76855,5360,70,,4587,0,1329,,,,,B
20200619,CO,264446,2230,29901,228,234545,2002,1417,15,5308,270,14,,,,,4280,A
20200619,CT,379878,7293,45557,117,334321,7176,4238,12,10099,172,0,,,,,7842,B
20200619,DC,73791,1592,9952,49,63839,1543,530,3,,184,0,63,,44,,1162,A+
20200619,DE,90434,1750,10611,112,79823,1638,504,2,,75,0,,,,,6395,A
20200619,FL,1532871,21559,89748,3822,1443123,17737,3197,43,13062,,200,,,,,,A
20200619,GA,670306,7102,62009,1097,608297,6005,2636,31,9772,937,109,,2122,,,,A
20200619,GU,9715,127,200,7,9515,120,5,0,,0,0,0,,0,,173,B
20200619,HI,65744,1370,762,18,64982,1352,17,0,95,,0,,,,,640,D
20200619,IA,246649,5718,25275,421,221374,5297,681,2,,197,0,60,,37,,15816,A+
20200619,ID,69545,1533,3743,111,65802,1422,89,1,278,28,3,9,101,,,3088,A
20200619,IL,1312003,27310,136470,831,1175533,26479,6718,0,,1837,0,512,,293,,,A
20200619,IN,392887,8165,41746,308,351141,7857,2516,25,6731,773,142,259,1465,111,,30760,A+
20200619,KS,147649,5525,12059,378,135590,5147,254,7,1035,,24,,338,,146,715,A
20200619,KY,311227,4847,13454,257,297773,4590,522,2,2494,339,12,64,978,,,3516,B
20200619,LA,590909,45688,48515,-119,542394,45807,3084,22,,561,0,,,75,,37017,B
20200619,MA,750807,9547,106650,228,644157,9319,7800,30,11036,994,51,199,,124,,91404,A+
20200619,MD,453669,6061,63548,319,390121,5742,3030,14,10447,648,90,261,,,,4685,A
20200619,ME,77161,3101,2913,35,74248,3066,102,0,328,26,5,11,,5,,2323,A
20200619,MI,879928,29742,67097,299,812831,29443,6067,6,,557,0,209,,99,,44964,A+
20200619,MN,475152,14273,32031,356,443121,13917,1393,17,3748,339,30,168,1150,,,27709,A
20200619,MO,306284,8942,17201,293,289083,8649,948,2,,594,0,,,70,,,B
20200619,MP,8169,0,30,0,8139,0,2,0,,,0,,,,,19,D
20200619,MS,238715,0,20641,0,218074,0,938,0,2767,661,0,159,,108,,15323,A
20200619,MT,68422,1552,666,11,67756,1541,20,0,82,9,1,,,,,546,C
20200619,NC,712313,18635,49840,1652,662473,16983,1197,22,,871,0,,,,,29219,A
20200619,ND,92606,1952,3226,33,89380,1919,71,1,210,26,2,,,,,2840,D
20200619,NE,147846,3033,17415,189,130431,2844,240,6,1166,149,25,,,,,11066,D
20200619,NH,103725,1741,5450,14,98275,1727,331,1,533,56,2,,158,,,4140,B
20200619,NJ,1194343,22609,168496,389,1025847,22220,12835,35,19267,1177,257,286,,231,,29209,A+
20200619,NM,280175,4278,10153,88,270022,4190,456,4,1726,157,11,,,,,4439,C
20200619,NV,234360,3564,12486,410,221874,3154,491,2,,370,0,87,,49,,652,A+
20200619,NY,3258963,79303,386556,796,2872407,78507,24686,25,89995,1284,0,359,,256,,69377,A
20200619,OH,616036,16012,43731,609,572305,15403,2667,34,7167,525,63,200,1820,133,,,B
20200619,OK,274578,5025,9706,352,264872,4673,367,1,1209,211,63,96,,,,7212,A+
20200619,OR,193917,4781,6572,206,187345,4575,188,1,946,154,13,50,,29,,2533,A+
20200619,PA,637218,13150,80762,526,556456,12624,6399,38,,731,0,,,169,,62186,A+
20200619,PR,119475,84,6195,84,113280,0,147,0,,78,0,7,,3,,,C
20200619,RI,140810,1240,16413,59,124397,1181,894,9,1922,123,11,23,,12,,1515,A+
20200619,SC,288300,7777,22631,1083,265669,6694,639,18,2294,660,239,,,,,10790,A
20200619,SD,71193,840,6158,49,65035,791,81,3,589,95,4,,,,,5276,B
20200619,TN,661689,9295,34017,1188,627672,8107,515,6,2238,635,29,,,,,22531,B
20200619,TX,1423914,16173,103305,3454,1320609,12719,2140,35,,3148,0,,,,,65329,B
20200619,UT,287358,4673,16425,586,270933,4087,155,3,1145,237,25,63,330,,148,9113,A
20200619,VA,512411,10343,56793,555,455618,9788,1602,16,8425,862,75,251,,121,,7563,A+
20200619,VI,2524,97,74,1,2450,96,6,0,,,0,,,,,64,C
20200619,VT,55887,1142,1144,9,54743,1133,56,0,,8,0,,,,,918,B
20200619,WA,474462,4419,28666,91,445796,4328,1245,19,3959,276,21,,,47,,,B
20200619,WI,471664,11161,26913,323,444751,10838,730,11,3177,240,17,91,704,,,18055,A+
20200619,WV,146014,1585,2435,17,143579,1568,88,0,,22,0,6,,2,,1665,B
20200619,WY,36474,320,1173,29,35301,291,20,2,98,8,1,,,,,889,C
20200618,AK,81185,3476,708,12,80477,3464,12,0,,18,0,,,0,,449,A
20200618,AL,322534,11811,28206,894,294328,10917,810,20,2373,663,21,,695,,405,15974,B
20200618,AR,228434,7735,13928,322,214506,7413,208,11,1074,226,22,,,53,173,9376,B
20200618,AS,174,0,0,0,174,0,0,0,,,0,,,,,,C
20200618,AZ,379732,13539,43443,2519,336289,11020,1271,32,4241,1667,17,540,,341,,6863,A+
20200618,CA,3074530,76542,161099,4084,2913431,72458,5290,82,,4584,0,1298,,,,,B
20200618,CO,262216,5549,29673,231,232543,5318,1402,29,5294,270,22,,,,,4253,A
20200618,CT,372585,4727,45440,11,327145,4716,4226,7,10099,176,187,,,,,7842,B
20200618,DC,72199,2113,9903,56,62296,2057,527,4,,189,0,86,,45,,1155,A+
20200618,DE,88684,2097,10499,55,78185,2042,502,0,,79,0,,,,,6350,A
20200618,FL,1511312,25553,85926,3207,1425386,22346,3154,44,12862,,189,,,,,,A
20200618,GA,663204,12737,60912,882,602292,11855,2605,30,9663,921,120,,2109,,,,A
20200618,GU,9588,390,193,5,9395,385,5,0,,0,0,0,,0,,170,A
20200618,HI,64374,1131,744,4,63630,1127,17,0,95,,3,,,,,639,D
20200618,IA,240931,5800,24854,393,216077,5407,679,6,,188,0,64,,47,,15604,A+
20200618,ID,68012,1228,3632,92,64380,1136,88,0,275,23,0,7,101,,,3013,A
20200618,IL,1284693,25504,135639,593,1149054,24911,6718,52,,1878,0,538,,321,,,A
20200618,IN,384722,13540,41438,425,343284,13115,2491,16,6589,754,63,236,1389,103,,30175,A+
20200618,KS,142124,0,11681,0,130443,0,247,0,1011,,0,,333,,146,696,A
20200618,KY,306380,6511,13197,202,293183,6309,520,2,2482,400,27,68,975,,,3506,B
20200618,LA,545221,0,48634,0,496587,0,3062,0,,585,0,,,83,,37017,B
20200618,MA,741260,9214,106422,271,634838,8943,7770,36,10985,968,60,227,,125,,91404,A+
20200618,MD,447608,6265,63229,260,384379,6005,3016,20,10357,660,48,269,,,,4640,A
20200618,ME,74060,42,2878,42,71182,0,102,0,323,27,0,10,,4,,2300,A
20200618,MI,850186,301,66798,301,783388,0,6061,25,,557,0,209,,101,,44964,A+
20200618,MN,460879,12292,31675,379,429204,11913,1376,19,3718,345,29,171,1144,,,27566,A
20200618,MO,297342,12340,16908,283,280434,12057,946,37,,533,0,,,64,,,B
20200618,MP,8169,0,30,0,8139,0,2,0,,,0,,,,,19,D
20200618,MS,238715,-5674,20641,0,218074,-5674,938,0,2767,668,0,161,,100,,15323,A
20200618,MT,66870,1355,655,25,66215,1330,20,0,81,8,3,,,,,545,C
20200618,NC,693678,26256,48188,1333,645490,24923,1175,7,,857,0,,,,,29219,A
20200618,ND,90654,980,3193,27,87461,953,70,0,208,26,7,,,,,2809,D
20200618,NE,144813,2426,17226,195,127587,2231,234,3,1141,156,25,,,,,10761,D
20200618,NH,101984,1898,5436,72,96548,1826,330,4,531,56,10,,156,,,4104,B
20200618,NJ,1171734,23893,168107,404,1003627,23489,12800,31,19010,1258,0,319,,257,,29101,A+
20200618,NM,275897,4344,10065,132,265832,4212,452,5,1715,161,17,,,,,4351,C
20200618,NV,230796,3186,12076,234,218720,2952,489,3,,357,0,93,,55,,641,A+
20200618,NY,3179660,68541,385760,618,2793900,67923,24661,32,89995,1358,0,388,,278,,69243,A
20200618,OH,600024,15461,43122,700,556902,14761,2633,22,7104,547,53,219,1807,149,,,B
20200618,OK,269553,4121,9354,450,260199,3671,366,2,1146,197,0,89,,,,7071,A+
20200618,OR,189136,4786,6366,148,182770,4638,187,4,933,141,4,46,,28,,2502,A+
20200618,PA,624068,11237,80236,418,543832,10819,6361,42,,740,0,,,170,,60979,A+
20200618,PR,119391,108,6111,108,113280,0,147,0,,73,0,9,,5,,,C
20200618,RI,139570,1290,16354,71,123216,1219,885,9,1911,126,13,23,,13,,1502,A+
20200618,SC,280523,7769,21548,992,258975,6777,621,4,2055,626,0,,,,,9734,A
20200618,SD,70353,1365,6109,59,64244,1306,78,0,585,93,15,,,,,5221,B
20200618,TN,652394,7821,32829,686,619565,7135,509,12,2209,617,29,,,,,21949,B
20200618,TX,1407741,38103,99851,3516,1307890,34587,2105,43,,2947,0,,,,,63812,B
20200618,UT,282685,3993,15839,495,266846,3498,152,3,1120,282,18,66,326,,145,8786,A
20200618,VA,502068,7727,56238,463,445830,7264,1586,3,8350,857,-17,241,,129,,7493,A+
20200618,VI,2427,0,73,0,2354,0,6,0,,,0,,,,,64,C
20200618,VT,54745,1082,1135,5,53610,1077,56,1,,11,0,,,,,917,B
20200618,WA,470043,6619,28575,320,441468,6299,1226,-5,3938,263,23,,,47,,,B
20200618,WI,460503,10638,26590,461,433913,10177,719,7,3160,240,32,83,701,,,18055,A+
20200618,WV,144429,3059,2418,42,142011,3017,88,0,,25,0,5,,2,,1665,B
20200618,WY,36154,1085,1144,30,35010,1055,18,0,97,8,0,,,,,870,C
20200617,AK,77709,1494,696,20,77013,1474,12,0,,23,0,,,0,,438,A
20200617,AL,310723,5299,27312,400,283411,4899,790,5,2352,677,37,,687,,401,15974,B
20200617,AR,220699,15133,13606,415,207093,14718,197,15,1052,217,26,,,53,168,8996,A
20200617,AS,174,0,0,0,174,0,0,0,,,0,,,,,,C
20200617,AZ,366193,11859,40924,1827,325269,10032,1239,20,4224,1582,15,531,,346,,6715,A+
20200617,CA,2997988,60233,157015,3455,2840973,56778,5208,87,,4522,0,1318,,,,,B
20200617,CO,256667,3511,29442,143,227225,3368,1373,0,5272,290,3,,,,,4231,A
20200617,CT,367858,6438,45429,80,322429,6358,4219,9,9912,186,0,,,,,7611,B
20200617,DC,70086,2960,9847,29,60239,2931,523,3,,197,0,73,,47,,1155,A+
20200617,DE,86587,513,10444,41,76143,472,502,3,,83,0,,,,,6305,A
20200617,FL,1485759,25450,82719,2610,1403040,22840,3110,25,12673,,184,,,,,,A
20200617,GA,650467,15489,60030,952,590437,14537,2575,46,9543,881,89,,2084,,,,A
20200617,GU,9198,166,188,2,9010,164,5,0,,0,0,0,,0,,170,A
20200617,HI,63243,1215,740,4,62503,1211,17,0,92,,1,,,,,637,D
20200617,IA,235131,4493,24461,282,210670,4211,673,4,,188,0,64,,47,,15289,A+
20200617,ID,66784,1137,3540,78,63244,1059,88,0,275,28,5,8,101,,,2921,A
20200617,IL,1259189,29987,135046,546,1124143,29441,6666,87,,1878,0,563,,331,,,A
20200617,IN,371182,7437,41013,227,330169,7210,2475,28,6526,789,45,238,1384,105,,29671,A+
20200617,KS,142124,5162,11681,262,130443,4900,247,2,1011,,23,,333,,146,696,A
20200617,KY,299869,3836,12995,166,286874,3670,518,6,2455,416,19,61,971,,,3444,B
20200617,LA,545221,12504,48634,928,496587,11576,3062,20,,585,0,,,83,,37017,B
20200617,MA,732046,8399,106151,266,625895,8133,7734,69,10925,998,58,227,,135,,88725,A+
20200617,MD,441343,12118,62969,560,378374,11558,2996,14,10309,702,47,283,,,,4596,A
20200617,ME,74018,1683,2836,17,71182,1666,102,1,323,27,2,10,,5,,2275,A
20200617,MI,849885,14351,66497,228,783388,14123,6036,2,,562,0,210,,131,,44964,A+
20200617,MN,448587,19442,31296,414,417291,19028,1357,13,3689,351,31,181,1136,,,27404,A
20200617,MO,285002,211,16625,211,268377,0,909,27,,533,0,,,66,,,B
20200617,MP,8169,0,30,0,8139,0,2,0,,,0,,,,,19,D
20200617,MS,244389,3586,20641,489,223748,3097,938,23,2767,668,39,161,,100,,15323,A
20200617,MT,65515,1938,630,16,64885,1922,20,1,78,5,-1,,,,,538,C
20200617,NC,667422,16001,46855,1002,620567,14999,1168,14,,846,0,,,,,29219,A
20200617,ND,89674,1023,3166,42,86508,981,70,1,201,25,1,,,,,2756,D
20200617,NE,142387,2874,17031,180,125356,2694,231,11,1116,156,28,,,,,10529,D
20200617,NH,100086,1213,5364,19,94722,1194,326,6,521,62,2,,155,,,4067,B
20200617,NJ,1147841,16059,167703,277,980138,15782,12769,42,19010,1352,131,358,,254,,28966,A+
20200617,NM,271553,3632,9933,88,261620,3544,447,7,1698,156,12,,,,,4217,C
20200617,NV,227610,5136,11842,184,215768,4952,486,1,,360,0,96,,45,,640,A+
20200617,NY,3111119,59341,385142,567,2725977,58774,24629,21,89995,1479,0,431,,304,,69085,A
20200617,OH,584563,16430,42422,412,542141,16018,2611,14,7051,541,44,215,1797,148,,,B
20200617,OK,265432,3627,8904,259,256528,3368,364,1,1146,181,16,92,,,,6898,A+
20200617,OR,184350,4812,6218,120,178132,4692,183,1,929,158,17,54,,26,,2457,A+
20200617,PA,612831,9739,79818,335,533013,9404,6319,43,,788,0,,,179,,59863,A+
20200617,PR,119283,52,6003,52,113280,0,147,0,,78,0,8,,1,,,C
20200617,RI,138280,1258,16283,51,121997,1207,876,11,1898,126,9,17,,13,,1489,A+
20200617,SC,272754,5075,20556,566,252198,4509,617,10,2055,607,0,,,,,9734,A
20200617,SD,68988,1786,6050,84,62938,1702,78,1,570,91,8,,,,,5143,B
20200617,TN,644573,5583,32143,313,612430,5270,497,4,2180,632,34,,,,,21282,B
20200617,TX,1369638,21196,96335,3129,1273303,18067,2062,33,,2793,0,,,,,62368,B
20200617,UT,278692,2992,15344,407,263348,2585,149,4,1102,270,29,64,321,,142,8552,A
20200617,VA,494341,8903,55775,444,438566,8459,1583,13,8367,938,122,249,,120,,7429,A+
20200617,VI,2427,49,73,0,2354,49,6,0,,,0,,,,,64,C
20200617,VT,53663,773,1130,-1,52533,774,55,0,,5,0,,,,,915,B
20200617,WA,463424,8913,28255,330,435169,8583,1231,10,3915,256,21,,,47,,,B
20200617,WI,449865,9691,26129,285,423736,9406,712,9,3128,244,32,94,696,,,17613,A+
20200617,WV,141370,4299,2376,35,138994,4264,88,0,,23,0,7,,2,,1654,B
20200617,WY,35069,656,1114,25,33955,631,18,0,97,7,1,,,,,862,C
20200616,AK,76215,1778,676,12,75539,1766,12,0,,22,0,,,2,,429,A
20200616,AL,305424,2750,26912,640,278512,2110,785,11,2315,678,56,,682,,399,13508,B
20200616,AR,205566,1428,13191,274,192375,1154,182,0,1026,214,23,,,45,165,8352,A
20200616,AS,174,0,0,0,174,0,0,0,,,0,,,,,,C
20200616,AZ,354334,9077,39097,2392,315237,6685,1219,25,4209,1506,27,502,,340,,6598,A+
20200616,CA,2937755,69573,153560,2108,2784195,67465,5121,32,,4462,0,1272,,,,,B
20200616,CO,253156,4071,29299,169,223857,3902,1373,25,5269,276,25,,,,,4196,A
20200616,CT,361420,5043,45349,114,316071,4929,4210,6,9912,201,0,,,,,7611,B
20200616,DC,67126,1280,9818,19,57308,1261,520,5,,192,0,70,,49,,1155,A+
20200616,DE,86074,1388,10403,63,75671,1325,499,1,,87,0,,,,,6256,A
20200616,FL,1460309,30125,80109,2783,1380200,27342,3085,55,12489,,191,,,,,,A
20200616,GA,634978,4482,59078,664,575900,3818,2529,35,9454,875,132,,2065,,,,A
20200616,GU,9032,274,186,1,8846,273,5,0,,,0,,,,,169,B
20200616,HI,62028,554,736,8,61292,546,17,0,91,,0,,,,,630,D
20200616,IA,230638,3250,24179,126,206459,3124,669,14,,193,0,71,,49,,15025,A+
20200616,ID,65647,2667,3462,63,62185,2604,88,1,270,24,4,6,100,,,2877,A
20200616,IL,1229202,18729,134500,623,1094702,18106,6579,72,,1939,0,561,,331,,,A
20200616,IN,363745,7916,40786,356,322959,7560,2447,14,6481,860,30,313,1383,121,,29093,A+
20200616,KS,136962,0,11419,0,125543,0,245,0,988,,0,,327,,143,676,A
20200616,KY,296033,182,12829,182,283204,0,512,7,2436,395,3,69,969,,,3431,B
20200616,LA,532717,13992,47706,534,485011,13458,3042,24,,588,0,,,77,,37017,B
20200616,MA,723647,6416,105885,195,617762,6221,7665,18,10867,1045,50,244,,151,,88725,A+
20200616,MD,429225,8117,62409,377,366816,7740,2982,35,10262,742,40,284,,,,4579,B
20200616,ME,72335,1364,2819,9,69516,1355,101,0,321,30,4,10,,6,,2233,B
20200616,MI,835534,11497,66269,184,769265,11313,6034,17,,562,0,210,,131,,44964,A+
20200616,MN,429145,6223,30882,189,398263,6034,1344,9,3658,357,28,185,1128,,,27006,A
20200616,MO,284791,4850,16414,225,268377,4625,882,2,,524,0,,,66,,,B
20200616,MP,8169,0,30,0,8139,0,2,0,,,0,,,,,19,D
20200616,MS,240803,10300,20152,353,220651,9947,915,20,2728,668,48,160,,98,,15323,A
20200616,MT,63577,2640,614,5,62963,2635,19,0,79,8,1,,,,,535,C
20200616,NC,651421,12942,45853,751,605568,12191,1154,36,,829,0,,,,,29219,A
20200616,ND,88651,875,3124,23,85527,852,69,1,200,26,3,,,,,2720,D
20200616,NE,139513,1758,16851,126,122662,1632,220,4,1088,160,13,,,,,10351,D
20200616,NH,98873,0,5345,0,93528,0,320,0,519,69,0,,154,,,4041,B
20200616,NJ,1131782,15699,167426,323,964356,15376,12727,51,18879,1291,124,362,,245,,28872,A+
20200616,NM,267921,4256,9845,122,258076,4134,440,5,1686,161,61,,,,,4160,C
20200616,NV,222474,6040,11658,379,210816,5661,485,2,,349,0,87,,48,,640,A+
20200616,NY,3051778,60568,384575,631,2667203,59937,24608,29,89995,1538,0,449,,303,,68938,A
20200616,OH,568133,10965,42010,434,526123,10531,2597,24,7007,528,59,216,1784,151,,,B
20200616,OK,261805,10801,8645,228,253160,10573,363,4,1130,172,13,75,,,,6765,A+
20200616,OR,179538,3402,6098,278,173440,3124,182,2,912,141,13,50,,22,,2431,A+
20200616,PA,603092,10062,79483,362,523609,9700,6276,33,,800,0,,,179,,59612,A+
20200616,PR,119231,61,5951,61,113280,0,147,0,,94,0,9,,1,,,C
20200616,RI,137022,1538,16232,52,120790,1486,865,14,1889,129,7,16,,13,,1479,A+
20200616,SC,267679,12122,19990,612,247689,11510,607,5,2055,571,67,,,,,9734,A
20200616,SD,67202,807,5966,38,61236,769,77,2,562,92,18,,,,,5069,B
20200616,TN,638990,9012,31830,670,607160,8342,493,10,2146,621,40,,,,,20710,B
20200616,TX,1348442,33681,93206,4098,1255236,29583,2029,46,,2518,0,,,,,60681,B
20200616,UT,275700,2762,14937,329,260763,2433,145,2,1073,271,32,,311,,138,8470,B
20200616,VA,485438,6439,55331,445,430107,5994,1570,18,8245,904,113,241,,125,,7341,A+
20200616,VI,2378,0,73,0,2305,0,6,0,,,0,,,,,64,C
20200616,VT,52890,333,1131,3,51759,330,55,0,,12,0,,,,,914,B
20200616,WA,454511,10942,27925,432,426586,10510,1221,4,3894,235,38,,,38,,,B
20200616,WI,440174,11181,25844,298,414330,10883,703,9,3096,275,35,100,687,,,17122,A+
20200616,WV,137071,5118,2341,43,134730,5075,88,0,,24,0,8,,3,,1636,B
20200616,WY,34413,1807,1089,29,33324,1778,18,0,96,7,3,,,,,852,C
20200615,AK,74437,970,664,3,73773,967,12,0,,21,0,,,3,,417,A
20200615,AL,302674,5219,26272,657,276402,4562,774,1,2259,546,4,,676,,395,13508,B
20200615,AR,204138,7149,12917,416,191221,6733,182,3,1003,206,5,,,45,163,8352,B
20200615,AS,174,0,0,0,174,0,0,0,,,0,,,,,,C
20200615,AZ,345257,7212,36705,1014,308552,6198,1194,8,4182,1449,34,464,,307,,6462,A+
20200615,CA,2868182,66186,151452,2597,2716730,63589,5089,26,,4323,0,1270,,,,,B
20200615,CO,249085,4442,29130,113,219955,4329,1348,0,5244,276,0,,,,,4196,A
20200615,CT,356377,7271,45235,147,311142,7124,4204,3,9912,203,0,,,,,7611,B
20200615,DC,65846,1316,9799,32,56047,1284,515,0,,191,0,76,,48,,1155,A+
20200615,DE,84686,2899,10340,76,74346,2823,498,2,,88,0,,,,,6172,A
20200615,FL,1430184,21169,77326,1758,1352858,19411,3030,8,12298,,74,,,,,,A
20200615,GA,630496,9706,58414,733,572082,8973,2494,43,9322,865,74,,2043,,,,A
20200615,GU,8758,215,185,0,8573,215,5,0,,,0,,,,,169,B
20200615,HI,61474,1152,728,5,60746,1147,17,0,91,,2,,,,,629,D
20200615,IA,227388,2754,24053,127,203335,2627,655,3,,197,0,71,,51,,14625,A+
20200615,ID,62980,0,3399,0,59581,0,87,0,266,23,0,5,98,,,2837,A
20200615,IL,1210473,18627,133877,473,1076596,18154,6507,18,,1961,0,569,,340,,,A
20200615,IN,355829,7438,40430,521,315399,6917,2433,11,6451,882,32,305,1368,123,,28744,A+
20200615,KS,136962,7810,11419,372,125543,7438,245,2,988,,15,,327,,143,676,A
20200615,KY,295851,1266,12647,202,283204,1064,505,6,2433,383,0,63,969,,,3416,B
20200615,LA,518725,9393,47172,553,471553,8840,3018,4,,568,0,,,76,,37017,B
20200615,MA,717231,4521,105690,87,611541,4434,7647,23,10817,1026,15,253,,167,,88725,A+
20200615,MD,421108,5799,62032,331,359076,5468,2947,8,10222,745,57,292,,,,4567,B
20200615,ME,70971,1113,2810,17,68161,1096,101,1,317,31,3,11,,4,,2189,B
20200615,MI,824037,10539,66085,31,757952,10508,6017,1,,562,0,210,,139,,44964,A+
20200615,MN,422922,5212,30693,222,392229,4990,1335,6,3630,353,20,186,1121,,,26609,A
20200615,MO,279941,4452,16189,379,263752,4073,880,1,,612,0,,,64,,,B
20200615,MP,8169,0,30,0,8139,0,2,0,,,0,,,,,19,D
20200615,MS,230503,16450,19799,283,210704,16167,895,4,2680,661,15,163,,100,,15323,A
20200615,MT,60937,2030,609,8,60328,2022,19,0,78,7,1,,,,,510,C
20200615,NC,638479,11349,45102,983,593377,10366,1118,9,,797,0,,,,,29219,A
20200615,ND,87776,896,3101,21,84675,875,68,1,197,31,0,,,,,2683,F
20200615,NE,137755,1640,16725,92,121030,1548,216,0,1075,160,5,,,,,10121,D
20200615,NH,98873,2452,5345,46,93528,2406,320,2,519,69,6,,154,,,4041,B
20200615,NJ,1116083,18467,167103,222,948980,18245,12676,51,18755,1342,18,399,,267,,28819,A+
20200615,NM,263665,4671,9723,102,253942,4569,435,4,1625,162,0,,,,,4114,C
20200615,NV,216434,5823,11279,106,205155,5717,483,4,,346,0,85,,40,,636,A+
20200615,NY,2991210,56611,383944,620,2607266,55991,24579,28,89995,1608,0,470,,323,,68851,A
20200615,OH,557168,10948,41576,428,515592,10520,2573,16,6948,513,53,216,1776,157,,,B
20200615,OK,251004,186,8417,186,242587,0,359,0,1117,149,1,67,,,,6628,A+
20200615,OR,176136,2254,5820,184,170316,2070,180,4,899,125,24,50,,19,,2396,A+
20200615,PA,593030,9797,79121,323,513909,9474,6243,28,,851,0,,,178,,58549,A+
20200615,PR,119170,79,5890,79,113280,0,147,0,,104,0,8,,2,,,C
20200615,RI,135484,1787,16180,76,119304,1711,851,18,1882,127,29,21,,14,,1474,A+
20200615,SC,255557,7221,19378,583,236179,6638,602,2,1988,536,0,,,,,8682,A+
20200615,SD,66395,1076,5928,30,60467,1046,75,0,544,93,5,,,,,4961,B
20200615,TN,629978,14758,31160,728,598818,14030,483,8,2106,642,19,,,,,20062,B
20200615,TX,1314761,18778,89108,1254,1225653,17524,1983,7,,2326,0,,,,,59089,B
20200615,UT,272938,5225,14608,295,258330,4930,143,4,1041,184,13,72,304,,134,8380,B
20200615,VA,478999,9999,54886,380,424113,9619,1552,6,8132,902,-4,269,,130,,7230,A+
20200615,VI,2378,1,73,1,2305,0,6,0,,,0,,,,,64,C
20200615,VT,52557,1575,1128,1,51429,1574,55,0,,16,0,,,,,912,B
20200615,WA,443569,10675,27493,398,416076,10277,1217,4,3856,197,11,,,41,,,B
20200615,WI,428993,6287,25546,206,403447,6081,694,2,3061,284,12,100,680,,,16837,A+
20200615,WV,131953,754,2298,9,129655,745,88,0,,25,0,8,,2,,1585,B
20200615,WY,32606,-459,1060,0,31546,-459,18,0,93,4,0,,,,,834,C
20200614,AK,73467,1664,661,7,72806,1657,12,0,,11,0,,,1,,411,A
20200614,AL,297455,4203,25615,1014,271840,3189,773,0,2255,540,14,,675,,395,13508,B
20200614,AR,196989,9972,12501,954,184488,9018,179,3,998,204,19,,,46,162,8110,A
20200614,AS,174,0,0,0,174,0,0,0,,,0,,,,,,C
20200614,AZ,338045,9648,35691,1233,302354,8415,1186,3,4148,1457,33,452,,317,,6333,A+
20200614,CA,2801996,77603,148855,3212,2653141,74391,5063,74,,4247,0,1280,,,,,B
20200614,CO,244643,8182,29017,195,215626,7987,1348,0,5244,262,10,,,,,4178,A
20200614,CT,349106,4852,45088,94,304018,4758,4201,15,9912,205,0,,,,,7611,B
20200614,DC,64530,1494,9767,58,54763,1436,515,4,,186,0,71,,50,,1150,A+
20200614,DE,81787,1688,10264,35,71523,1653,496,1,,93,0,,,,,6172,A
20200614,FL,1409015,38602,75568,2016,1333447,36586,3022,6,12224,,69,,,,,,A
20200614,GA,620790,21110,57681,880,563109,20230,2451,5,9248,829,24,,2034,,,,A
20200614,GU,8543,0,185,0,8358,0,5,0,,,0,,,,,168,B
20200614,HI,60322,984,723,17,59599,967,17,0,89,,2,,,,,628,D
20200614,IA,224634,5026,23926,209,200708,4817,652,2,,203,0,77,,47,,14383,A+
20200614,ID,62980,322,3399,46,59581,276,87,0,266,22,1,6,98,,,2837,A
20200614,IL,1191846,22040,133404,672,1058442,21368,6489,19,,1914,0,562,,328,,,A
20200614,IN,348391,7754,39909,366,308482,7388,2422,9,6419,869,70,301,1360,113,,28522,A+
20200614,KS,129152,0,11047,0,118105,0,243,0,973,,0,,324,,143,667,A
20200614,KY,294585,0,12445,0,282140,0,499,0,2433,410,0,68,969,,,3409,B
20200614,LA,509332,4949,46619,336,462713,4613,3014,10,,556,0,,,76,,33904,B
20200614,MA,712710,9114,105603,208,607107,8906,7624,48,10802,1039,30,244,,156,,88725,A+
20200614,MD,415309,6551,61701,396,353608,6155,2939,13,10165,751,112,313,,,,4541,B
20200614,ME,69858,1508,2793,36,67065,1472,100,0,314,29,1,10,,5,,2173,B
20200614,MI,813498,14015,66054,218,747444,13797,6016,3,,636,0,253,,139,,44964,A+
20200614,MN,417710,0,30471,6,387239,-6,1329,15,3610,369,29,186,1110,,,26090,A
20200614,MO,275489,5693,15810,0,259679,5693,879,0,,647,0,,,65,,,B
20200614,MP,8169,233,30,0,8139,233,2,0,,,0,,,,,19,D
20200614,MS,214053,168,19516,168,194537,0,891,2,2665,667,21,151,,99,,13356,A
20200614,MT,58907,903,601,13,58306,890,19,1,77,6,0,,,,,510,C
20200614,NC,627130,15440,44119,1443,583011,13997,1109,5,,798,0,,,,,23653,A
20200614,ND,86880,1007,3080,22,83800,985,67,0,197,35,0,,,,,2658,F
20200614,NE,136115,1738,16633,120,119482,1618,216,0,1070,156,3,,,,,9879,D
20200614,NH,96421,2465,5299,48,91122,2417,318,3,513,70,10,,152,,,3905,B
20200614,NJ,1097616,19401,166881,276,930735,19125,12625,36,18737,1391,30,386,,285,,28714,A+
20200614,NM,258994,3710,9621,95,249373,3615,431,5,1625,172,0,,,,,4072,C
20200614,NV,210611,5731,11173,227,199438,5504,479,1,,332,0,83,,69,,627,A+
20200614,NY,2934599,62359,383324,694,2551275,61665,24551,24,89995,1657,0,499,,346,,68761,A
20200614,OH,546220,7322,41148,300,505072,7022,2557,3,6895,511,31,216,1762,145,,,B
20200614,OK,250818,4379,8231,158,242587,4221,359,0,1116,149,5,67,,,,6578,A+
20200614,OR,173882,3403,5636,101,168246,3302,176,2,875,133,0,47,,15,,2396,A+
20200614,PA,583233,8182,78798,336,504435,7846,6215,4,,852,0,,,189,,58310,A+
20200614,PR,119091,121,5811,121,113280,0,147,1,,110,0,6,,2,,,C
20200614,RI,133697,916,16104,32,117593,884,833,0,1853,141,0,28,,17,,1435,A+
20200614,SC,248336,6430,18795,840,229541,5590,600,1,1988,521,0,,,,,8682,A+
20200614,SD,65319,806,5898,65,59421,741,75,0,539,87,8,,,,,4899,B
20200614,TN,615220,13858,30432,891,584788,12967,475,3,2087,588,14,,,,,19896,B
20200614,TX,1295983,35664,87854,1843,1208129,33821,1976,19,,2287,0,,,,,58341,B
20200614,UT,267713,4931,14313,332,253400,4599,139,0,1028,178,16,,302,,134,8252,B
20200614,VA,469000,9007,54506,637,414494,8370,1546,5,8136,958,46,334,,155,,7178,A+
20200614,VI,2377,21,72,0,2305,21,6,0,,,0,,,,,64,C
20200614,VT,50982,1049,1127,2,49855,1047,55,0,,26,0,,,,,909,B
20200614,WA,432894,3760,27095,110,405799,3650,1213,9,3845,229,28,,,49,,,B
20200614,WI,422706,9218,25340,251,397366,8967,692,1,3049,289,14,101,680,,,16558,A+
20200614,WV,131199,3682,2289,30,128910,3652,88,0,,30,0,8,,2,,1571,B
20200614,WY,33065,10,1060,10,32005,0,18,0,93,5,0,,,,,834,C
20200613,AK,71803,923,654,29,71149,894,12,0,,12,0,,,2,,405,A
20200613,AL,293252,6867,24601,891,268651,5976,773,4,2241,622,39,,672,,395,13508,B
20200613,AR,187017,5895,11547,0,175470,5895,176,0,979,203,18,,,49,160,7607,A
20200613,AS,174,0,0,0,174,0,0,0,,,0,,,,,,C
20200613,AZ,328397,5618,34458,1540,293939,4078,1183,39,4115,1412,36,447,,309,,6209,A+
20200613,CA,2724393,62135,145643,3660,2578750,58475,4989,46,,4411,0,1313,,,,,B
20200613,CO,236461,2091,28822,175,207639,1916,1348,9,5234,274,177,,,,,4184,A
20200613,CT,344254,14000,44994,305,299260,13695,4186,27,9912,233,0,,,,,7611,B
20200613,DC,63036,1083,9709,55,53327,1028,511,5,,197,0,78,,52,,1143,A+
20200613,DE,80099,2405,10229,56,69870,2349,495,1,,93,0,,,,,6116,A
20200613,FL,1370413,34514,73552,2581,1296861,31933,3016,49,12155,,169,,,,,,A
20200613,GA,599680,7722,56801,1018,542879,6704,2446,28,9224,810,43,,2029,,,,A
20200613,GU,8543,16,185,1,8358,15,5,0,,,0,,,,,168,B
20200613,HI,59338,759,706,14,58632,745,17,0,87,,1,,,,,627,D
20200613,IA,219608,5064,23717,380,195891,4684,650,7,,200,0,76,,43,,14326,A+
20200613,ID,62658,1226,3353,51,59305,1175,87,1,265,24,0,5,98,,,2776,A
20200613,IL,1169806,21844,132732,673,1037074,21171,6470,29,,2117,0,610,,352,,,A
20200613,IN,340637,5457,39543,397,301094,5060,2413,17,6349,871,0,316,1354,118,,28241,A+
20200613,KS,129152,0,11047,0,118105,0,243,0,973,,0,,324,,143,667,A
20200613,KY,294585,13491,12445,500,282140,12991,499,6,2433,410,27,68,969,,,3409,B
20200613,LA,504383,24849,46283,1288,458100,23561,3004,8,,542,0,,,76,,33904,B
20200613,MA,703596,10237,105395,336,598201,9901,7576,38,10772,1069,46,249,,162,,88725,A+
20200613,MD,408758,8663,61305,692,347453,7971,2926,26,10053,799,130,321,,,,4536,B
20200613,ME,68350,1463,2757,36,65593,1427,100,0,313,29,5,10,,4,,2152,B
20200613,MI,799483,13196,65836,164,733647,13032,6013,23,,636,0,253,,139,,44964,A+
20200613,MN,417710,9658,30465,2,387245,9656,1314,9,3581,390,24,191,1104,,,25620,A
20200613,MO,269796,4661,15810,225,253986,4436,879,7,,595,0,,,69,,,B
20200613,MP,7936,174,30,0,7906,174,2,0,,,0,,,,,19,D
20200613,MS,213885,-608,19348,257,194537,-865,889,8,2644,684,1,160,,103,,13356,A
20200613,MT,58004,982,588,15,57416,967,18,0,77,7,0,,,,,510,C
20200613,NC,611690,15993,42676,1427,569014,14566,1104,12,,823,0,,,,,23653,A
20200613,ND,85873,1709,3058,42,82815,1667,67,0,197,35,0,,,,,2630,F
20200613,NE,134377,3604,16513,198,117864,3406,216,4,1067,157,38,,,,,9610,D
20200613,NH,93956,2039,5251,42,88705,1997,315,7,503,76,-1,,149,,,3843,B
20200613,NJ,1078215,22819,166605,441,911610,22378,12589,100,18707,1395,100,409,,279,,28606,A+
20200613,NM,255284,0,9526,0,245758,0,426,0,1625,179,0,,,,,3983,C
20200613,NV,204880,5433,10946,268,193934,5165,478,3,,351,0,81,,43,,627,A+
20200613,NY,2872240,70840,382630,916,2489610,69924,24527,32,89995,1734,0,517,,360,,68584,A
20200613,OH,538898,15180,40848,424,498050,14756,2554,46,6864,516,50,230,1754,152,,,B
20200613,OK,246439,225,8073,225,238366,0,359,0,1111,154,8,67,,,,6495,A+
20200613,OR,170479,4290,5535,158,164944,4132,174,1,875,133,0,47,,15,,2396,A+
20200613,PA,575051,8667,78462,463,496589,8204,6211,49,,875,0,,,192,,58061,A+
20200613,PR,118970,154,5690,154,113280,0,146,0,,117,0,4,,3,,,C
20200613,RI,132781,1275,16072,49,116709,1226,833,0,1853,141,0,28,,17,,1435,A+
20200613,SC,241906,5847,17955,785,223951,5062,599,6,1988,523,0,,,,,8682,A+
20200613,SD,64513,1508,5833,91,58680,1417,75,1,531,85,6,,,,,4828,B
20200613,TN,601362,11189,29541,415,571821,10774,472,4,2073,583,24,,,,,19731,B
20200613,TX,1260319,33362,86011,2331,1174308,31031,1957,18,,2242,0,,,,,56535,B
20200613,UT,262782,3996,13981,404,248801,3592,139,0,1012,236,24,,300,,132,8114,B
20200613,VA,459993,9463,53869,658,406124,8805,1541,7,8090,959,62,295,,142,,7131,A+
20200613,VI,2356,63,72,0,2284,63,6,0,,,0,,,,,64,C
20200613,VT,49933,1299,1125,6,48808,1293,55,0,,11,0,,,,,908,B
20200613,WA,429134,6089,26985,160,402149,5929,1204,10,3817,225,45,,,43,,,B
20200613,WI,413488,11331,25089,294,388399,11037,691,2,3035,285,32,99,677,,,16231,A+
20200613,WV,127517,3478,2259,26,125258,3452,88,2,,29,0,9,,2,,1568,B
20200613,WY,33055,1155,1050,23,32005,1132,18,0,93,5,1,,,,,833,C
20200612,AK,70880,1869,625,14,70255,1855,12,1,,15,0,,,3,,403,A
20200612,AL,286385,7559,23710,865,262675,6694,769,14,2202,622,37,,658,,384,13508,B
20200612,AR,181122,4457,11547,731,169575,3726,176,5,961,203,36,,,49,157,7607,A
20200612,AS,174,0,0,0,174,0,0,0,,,0,,,,,,C
20200612,AZ,322779,13197,32918,1654,289861,11543,1144,17,4079,1336,38,429,,278,,5980,A+
20200612,CA,2662258,64611,141983,2702,2520275,61909,4943,62,,4480,0,1310,,,,,B
20200612,CO,234370,4025,28647,148,205723,3877,1339,11,5057,279,22,,,,,4169,A
20200612,CT,330254,8306,44689,228,285565,8078,4159,13,9912,244,0,,,,,7611,B
20200612,DC,61953,2665,9654,65,52299,2600,506,4,,212,0,82,,57,,1143,A+
20200612,DE,77694,3661,10173,67,67521,3594,494,0,,100,0,,,,,6062,A
20200612,FL,1335899,29151,70971,1902,1264928,27249,2967,29,11986,,136,,,,,,A
20200612,GA,591958,7717,55783,810,536175,6907,2418,43,9181,836,108,,2021,,,,A
20200612,GU,8527,147,184,1,8343,146,5,0,,,0,,,,,168,B
20200612,HI,58579,1284,692,7,57887,1277,17,0,86,,1,,,,,623,D
20200612,IA,214544,6005,23337,399,191207,5606,643,4,,225,0,81,,47,,14227,A+
20200612,ID,61432,1317,3302,42,58130,1275,86,1,265,20,3,5,98,,,2684,A
20200612,IL,1147962,24911,132059,732,1015903,24179,6441,78,,2209,0,648,,375,,,A
20200612,IN,335180,7838,39146,398,296034,7440,2396,16,6349,906,35,329,1354,116,,27811,A+
20200612,KS,129152,5410,11047,235,118105,5175,243,3,973,,19,,324,,143,667,A
20200612,KY,281094,0,11945,0,269149,0,493,0,2406,514,0,81,967,,,3379,B
20200612,LA,479534,9861,44995,523,434539,9338,2996,9,,549,0,,,74,,33904,B
20200612,MA,693359,10271,105059,392,588300,9879,7538,46,10726,1143,72,276,,170,,88725,A+
20200612,MD,400095,7725,60613,416,339482,7309,2900,25,9923,836,134,331,,,,4474,B
20200612,ME,66887,1430,2721,54,64166,1376,100,0,308,32,0,11,,5,,2105,B
20200612,MI,786287,15767,65672,223,720615,15544,5990,5,,636,0,253,,139,,42041,A+
20200612,MN,408052,12818,30463,45,377589,12773,1305,25,3557,403,35,191,1093,,,25028,A
20200612,MO,265135,6095,15585,195,249550,5900,872,12,,593,0,,,69,,,B
20200612,MP,7762,181,30,0,7732,181,2,0,,,0,,,,,19,D
20200612,MS,214493,608,19091,608,195402,0,881,13,2643,710,29,172,,94,,13356,A
20200612,MT,57022,1245,573,10,56449,1235,18,0,77,7,3,,,,,489,C
20200612,NC,595697,23020,41249,1768,554448,21252,1092,28,,760,0,,,,,23653,A
20200612,ND,84164,1376,3016,36,81148,1340,67,0,197,35,4,,,,,2573,F
20200612,NE,130773,3111,16315,290,114458,2821,212,17,1029,164,29,,,,,9229,D
20200612,NH,91917,2010,5209,31,86708,1979,308,7,504,73,4,,149,,,3665,A
20200612,NJ,1055396,24603,166164,348,889232,24255,12489,46,18607,1480,115,415,,300,,28509,A+
20200612,NM,255284,9727,9526,276,245758,9451,426,16,1625,179,42,,,,,3983,C
20200612,NV,199447,6193,10678,279,188769,5914,475,0,,328,0,77,,36,,604,A+
20200612,NY,2801400,72395,381714,822,2419686,71573,24495,53,89995,1898,0,552,,387,,68399,A
20200612,OH,523718,11135,40424,420,483294,10715,2508,18,6814,547,61,217,1745,144,,,B
20200612,OK,246214,4769,7848,222,238366,4547,359,2,1103,154,11,65,,,,6391,A+
20200612,OR,166189,4385,5377,140,160812,4245,173,2,875,133,11,47,,15,,2370,A+
20200612,PA,566384,12012,77999,66,488385,11946,6162,49,,899,0,,,202,,56939,A+
20200612,PR,118816,24779,5536,184,113280,24595,146,2,,92,0,7,,4,,,C
20200612,RI,131506,2174,16023,81,115483,2093,833,10,1853,141,11,28,,17,,1435,A+
20200612,SC,236059,6002,17170,729,218889,5273,593,5,1988,512,90,,,,,8682,A+
20200612,SD,63005,1261,5742,77,57263,1184,74,1,525,87,11,,,,,4755,B
20200612,TN,590173,54879,29126,588,561047,54291,468,27,2049,608,38,,,,,19425,B
20200612,TX,1226957,20637,83680,2097,1143277,18540,1939,19,,2166,0,,,,,55258,B
20200612,UT,258786,4118,13577,325,245209,3793,139,8,988,197,20,,294,,130,7935,B
20200612,VA,450530,43133,53211,564,397319,42569,1534,14,8028,1026,64,297,,143,,7002,A+
20200612,VI,2293,41,72,0,2221,41,6,0,,,0,,,,,64,C
20200612,VT,48634,1425,1119,9,47515,1416,55,0,,16,0,,,,,907,B
20200612,WA,423045,9191,26825,266,396220,8925,1194,4,3772,226,-1,,,8,,,B
20200612,WI,402157,11662,24795,354,377362,11308,689,7,3003,287,27,104,670,,,15783,A+
20200612,WV,124039,2919,2233,21,121806,2898,86,1,,29,0,9,,2,,1553,B
20200612,WY,31900,282,1027,18,30873,264,18,0,92,5,0,,,,,814,C
20200611,AK,69011,1291,611,18,68400,1273,11,0,,18,0,,,4,,397,A
20200611,AL,278826,5769,22845,856,255981,4913,755,11,2165,647,36,,650,,380,13508,B
20200611,AR,176665,448,10816,448,165849,0,171,6,925,187,24,,,45,150,7351,A
20200611,AS,174,0,0,0,174,0,0,0,,,0,,,,,,C
20200611,AZ,309582,9895,31264,1412,278318,8483,1127,32,4041,1291,41,429,,278,,5980,A+
20200611,CA,2597647,56849,139281,3090,2458366,53759,4881,105,,4534,0,1325,,,,,B
20200611,CO,230345,4251,28499,152,201846,4099,1328,16,5035,277,10,,,,,4150,A
20200611,CT,321948,5035,44461,114,277487,4921,4146,26,9912,246,243,,,,,7611,B
20200611,DC,59288,1096,9589,52,49699,1044,502,3,,238,0,82,,53,,1143,A+
20200611,DE,74033,2288,10106,50,63927,2238,494,1,,109,0,,,,,6001,A
20200611,FL,1306748,27725,69069,1698,1237679,26027,2938,49,11850,,229,,,,,,A
20200611,GA,584241,13286,54973,993,529268,12293,2375,46,9073,842,99,,2006,,,,A
20200611,GU,8380,98,183,1,8197,97,5,0,,,0,,,,,168,B
20200611,HI,57295,1122,685,3,56610,1119,17,0,85,,1,,,,,622,D
20200611,IA,208539,5710,22938,387,185601,5323,639,9,,242,0,75,,48,,13956,A+
20200611,ID,60115,1063,3260,40,56855,1023,85,0,262,28,0,7,99,,,2628,A
20200611,IL,1123051,22325,131327,766,991724,21559,6363,90,,2365,0,638,,379,,,B
20200611,IN,327342,7248,38748,411,288594,6837,2380,25,6314,887,53,331,1345,118,,27321,A+
20200611,KS,123742,0,10812,0,112930,0,240,0,954,,0,,316,,139,657,A
20200611,KY,281094,6680,11945,62,269149,6618,493,9,2406,514,10,81,967,,,3379,B
20200611,LA,469673,9553,44472,442,425201,9111,2987,19,,553,0,,,77,,33904,B
20200611,MA,683088,10998,104667,511,578421,10487,7492,38,10654,1260,72,296,,181,,88725,A+
20200611,MD,392370,7728,60197,732,332173,6996,2875,31,9789,902,34,358,,,,4365,B
20200611,ME,65457,1517,2667,30,62790,1487,100,0,308,29,5,12,,5,,2062,B
20200611,MI,770520,14469,65449,267,705071,14202,5985,33,,661,0,249,,150,,42041,A+
20200611,MN,395234,13401,30418,219,364816,13182,1280,13,3522,411,40,196,1091,,,24870,A
20200611,MO,259040,7411,15390,203,243650,7208,860,12,,537,0,,,59,,,B
20200611,MP,7581,58,30,0,7551,58,2,0,,,0,,,,,19,D
20200611,MS,213885,0,18483,0,195402,0,868,0,2614,655,0,160,,99,,13356,A
20200611,MT,55777,1161,563,2,55214,1159,18,0,74,7,0,,,,,487,C
20200611,NC,572677,19027,39481,1310,533196,17717,1064,11,,812,0,,,,,23653,A
20200611,ND,82788,1128,2980,39,79808,1089,67,0,193,32,0,,,,,2515,D
20200611,NE,127662,2500,16025,142,111637,2358,195,4,1000,175,11,,,,,8946,D
20200611,NH,89907,1260,5178,46,84729,1214,301,7,500,81,4,,147,,,3585,B
20200611,NJ,1030793,21859,165816,470,864977,21389,12443,66,18492,1512,269,445,,319,,28376,A+
20200611,NM,245557,3900,9250,145,236307,3755,410,6,1583,197,0,,,,,3806,C
20200611,NV,193254,5931,10399,235,182855,5696,475,1,,337,0,72,,35,,560,A+
20200611,NY,2729005,60839,380892,736,2348113,60103,24442,38,89995,2042,0,581,,424,,68211,A
20200611,OH,512583,10699,40004,429,472579,10270,2490,33,6753,563,60,225,1732,155,,,B
20200611,OK,241445,4148,7626,146,233819,4002,357,2,1092,153,17,58,,,,6263,A+
20200611,OR,161804,5046,5237,177,156567,4869,171,2,864,130,7,39,,19,,2350,A+
20200611,PA,554372,9942,77933,467,476439,9475,6113,51,,946,0,,,215,,55665,A+
20200611,PR,94037,23,5352,23,88685,0,144,1,,91,0,7,,4,,,C
20200611,RI,129332,1525,15942,87,113390,1438,823,11,1842,146,14,26,,16,,1419,A+
20200611,SC,230057,-22475,16441,682,213616,-23157,588,13,1898,494,0,,,,,7928,A+
20200611,SD,61744,1059,5665,61,56079,998,73,4,514,87,11,,,,,4664,B
20200611,TN,535294,6467,28538,477,506756,5990,441,5,2011,606,21,,,,,18992,B
20200611,TX,1206320,45233,81583,1826,1124737,43407,1920,35,,2008,0,,,,,54096,B
20200611,UT,254668,4908,13252,388,241416,4520,131,3,968,188,14,,282,,123,7745,B
20200611,VA,407397,9033,52647,470,354750,8563,1520,6,7964,1069,-17,273,,138,,6895,A+
20200611,VI,2252,11,72,0,2180,11,6,0,,,0,,,,,64,C
20200611,VT,47209,1467,1110,15,46099,1452,55,0,,12,0,,,,,905,B
20200611,WA,413854,11209,26559,278,387295,10931,1190,14,3773,226,26,,,63,,,B
20200611,WI,390495,9313,24441,371,366054,8942,682,11,2976,306,33,101,660,,,15348,A+
20200611,WV,121120,3130,2212,24,118908,3106,85,0,,38,0,8,,2,,1516,B
20200611,WY,31618,766,1009,29,30609,737,18,0,92,7,0,,,,,814,C
20200610,AK,67720,830,593,20,67127,810,11,0,,22,0,,,3,,392,A
20200610,AL,273057,5318,21989,567,251068,4751,744,15,2129,629,42,,646,,378,13508,B
20200610,AR,176217,10436,10368,288,165849,10148,165,4,901,181,36,,,49,147,7116,A
20200610,AS,174,0,0,0,174,0,0,0,,,0,,,,,,C
20200610,AZ,299687,6474,29852,1556,269835,4918,1095,25,4000,1274,41,413,,273,,5851,A+
20200610,CA,2540798,54553,136191,2702,2404607,51851,4776,79,,4719,0,1326,,,,,B
20200610,CO,226094,4207,28347,164,197747,4043,1312,20,5025,305,166,,,,,4130,A
20200610,CT,316913,4262,44347,168,272566,4094,4120,23,9669,270,0,,,,,7284,B
20200610,DC,58192,1040,9537,63,48655,977,499,4,,245,0,79,,60,,1143,A+
20200610,DE,71745,992,10056,36,61689,956,493,1,,108,0,,,,,5939,A
20200610,FL,1279023,20718,67371,1371,1211652,19347,2889,38,11621,,161,,,,,,A
20200610,GA,570955,13772,53980,731,516975,13041,2329,44,8974,817,102,,1991,,,,A
20200610,GU,8282,306,182,2,8100,304,5,0,,,0,,,,,164,B
20200610,HI,56173,699,682,6,55491,693,17,0,84,,0,,,,,621,D
20200610,IA,202829,5106,22551,315,180278,4791,630,6,,245,0,73,,49,,13628,A+
20200610,ID,59052,1375,3220,31,55832,1344,85,2,262,20,2,7,99,,,2554,A
20200610,IL,1100726,20820,130561,625,970165,20195,6273,77,,2458,0,706,,394,,,A
20200610,IN,320094,4704,38337,304,281757,4400,2355,16,6261,894,36,307,1334,113,,26791,A+
20200610,KS,123742,4233,10812,162,112930,4071,240,4,954,,18,,316,,139,657,A
20200610,KY,274414,14476,11883,175,262531,14301,484,7,2396,508,10,68,966,,,3375,B
20200610,LA,460120,6452,44030,418,416090,6034,2968,11,,549,0,,,72,,33904,B
20200610,MA,672090,10098,104156,267,567934,9831,7454,46,10582,1345,75,319,,200,,84621,A+
20200610,MD,384642,6560,59465,561,325177,5999,2844,33,9755,955,79,379,,,,4310,B
20200610,ME,63940,1520,2637,31,61303,1489,100,0,303,27,1,10,,5,,2023,B
20200610,MI,756051,15,65182,15,690869,0,5952,1,,661,0,249,,150,,42041,A+
20200610,MN,381833,12040,30199,333,351634,11707,1267,39,3482,427,41,193,1083,,,24675,A
20200610,MO,251629,5934,15187,274,236442,5660,848,8,,533,0,,,59,,,B
20200610,MP,7523,0,30,0,7493,0,2,0,,,0,,,,,19,D
20200610,MS,213885,5673,18483,715,195402,4958,868,31,2614,655,79,160,,99,,13356,A
20200610,MT,54616,1432,561,7,54055,1425,18,0,74,7,2,,,,,487,C
20200610,NC,553650,17939,38171,1011,515479,16928,1053,24,,780,0,,,,,23653,A
20200610,ND,81660,994,2941,40,78719,954,67,2,193,33,4,,,,,2482,D
20200610,NE,125162,2470,15883,131,109279,2339,191,3,989,181,22,,,,,8820,D
20200610,NH,88647,1524,5132,53,83515,1471,294,8,496,80,4,,146,,,3501,B
20200610,NJ,1008934,19437,165346,550,843588,18887,12377,74,18223,1701,154,471,,342,,28207,A+
20200610,NM,241657,2856,9105,43,232552,2813,404,4,1583,193,25,,,,,3699,C
20200610,NV,187323,3734,10164,134,177159,3600,474,2,,359,0,70,,38,,557,A+
20200610,NY,2668166,62297,380156,674,2288010,61623,24404,56,89995,2190,0,630,,462,,68019,A
20200610,OH,501884,11494,39575,413,462309,11081,2457,36,6693,575,73,232,1714,159,,,B
20200610,OK,237297,3256,7480,117,229817,3139,355,2,1075,150,14,63,,,,6166,A+
20200610,OR,156758,3141,5060,72,151698,3069,169,0,857,136,6,40,,18,,2332,A+
20200610,PA,544430,8126,77466,410,466964,7716,6062,48,,992,0,,,218,,54560,A+
20200610,PR,94014,144,5329,144,88685,0,143,1,,97,0,8,,5,,,C
20200610,RI,127807,1468,15855,104,111952,1364,812,4,1828,148,13,27,,16,,1406,A+
20200610,SC,252532,4550,15759,531,236773,4019,575,7,1898,513,0,,,,,7928,A+
20200610,SD,60685,1526,5604,81,55081,1445,69,1,503,101,16,,,,,4573,B
20200610,TN,528827,7630,28061,486,500766,7144,436,1,1990,624,16,,,,,18516,B
20200610,TX,1161087,13732,79757,2504,1081330,11228,1885,32,,2153,0,,,,,52449,B
20200610,UT,249760,2900,12864,305,236896,2595,128,1,954,223,23,,276,,116,7587,B
20200610,VA,398364,7508,52177,439,346187,7069,1514,18,7981,1155,135,296,,139,,6826,A+
20200610,VI,2241,33,72,1,2169,32,6,0,,,0,,,,,64,C
20200610,VT,45742,1514,1095,11,44647,1503,55,0,,11,0,,,,,903,B
20200610,WA,402645,11555,26281,277,376364,11278,1176,15,3747,238,48,,,92,,,B
20200610,WI,381182,10238,24070,336,357112,9902,671,10,2943,328,39,114,654,,,14999,A+
20200610,WV,117990,3652,2188,19,115802,3633,85,1,,24,0,9,,5,,1485,B
20200610,WY,30852,516,980,10,29872,506,18,1,92,8,1,,,,,804,C
20200609,AK,66890,978,573,10,66317,968,11,1,,12,0,,,1,,389,A
20200609,AL,267739,7748,21422,497,246317,7251,729,11,2087,600,33,,631,,375,11395,B
20200609,AR,165781,5194,10080,340,155701,4854,161,6,865,173,21,,,44,144,6875,A
20200609,AS,174,0,0,0,174,0,0,0,,,0,,,,,,C
20200609,AZ,293213,5132,28296,618,264917,4514,1070,23,3959,1243,48,438,,264,,5764,A+
20200609,CA,2486245,55055,133489,2170,2352756,52885,4697,44,,4583,0,1345,,,,,B
20200609,CO,221887,4403,28183,182,193704,4221,1292,18,4859,304,374,,,,,4112,A
20200609,CT,312651,4580,44179,87,268472,4493,4097,13,9669,293,0,,,,,7284,B
20200609,DC,57152,1386,9474,85,47678,1301,495,4,,255,0,89,,59,,1143,A+
20200609,DE,70753,806,10020,48,60733,758,492,2,,108,0,,,,,5888,A
20200609,FL,1258305,23755,66000,1096,1192305,22659,2851,53,11460,,178,,,,,,A
20200609,GA,557183,7808,53249,752,503934,7056,2285,77,8872,834,126,,1960,,,,A
20200609,GU,7976,247,180,1,7796,246,5,0,,,0,,,,,163,B
20200609,HI,55474,327,676,1,54798,326,17,0,84,,0,,,,,618,D
20200609,IA,197723,4101,22236,249,175487,3852,624,12,,255,0,82,,51,,13411,A+
20200609,ID,57677,1636,3189,50,54488,1586,83,0,260,21,0,7,99,,,2509,A
20200609,IL,1079906,20309,129936,797,949970,19512,6196,94,,2573,0,726,,437,,,A
20200609,IN,315390,5887,38033,410,277357,5477,2339,23,6225,853,46,307,1330,113,,26205,A+
20200609,KS,119509,0,10650,0,108859,0,236,0,936,,0,,311,,136,625,A
20200609,KY,259938,7081,11708,232,248230,6849,477,5,2386,525,18,75,966,,,3365,B
20200609,LA,453668,11066,43612,562,410056,10504,2957,13,,568,0,,,67,,33904,B
20200609,MA,661992,4723,103889,263,558103,4460,7408,55,10507,1397,82,315,,202,,84621,A+
20200609,MD,378082,6579,58904,500,319178,6079,2811,35,9676,970,47,386,,,,4279,B
20200609,ME,62420,775,2606,18,59814,757,100,1,302,29,1,10,,7,,1992,B
20200609,MI,756036,16872,65167,63,690869,16809,5951,9,,661,0,249,,150,,42041,A+
20200609,MN,369793,8881,29866,430,339927,8451,1228,20,3441,455,40,199,1068,,,24221,A
20200609,MO,245695,4234,14913,179,230782,4055,840,21,,533,0,,,59,,,B
20200609,MP,7523,281,30,2,7493,279,2,0,,,0,,,,,19,D
20200609,MS,208212,0,17768,0,190444,0,837,0,2535,598,0,142,,83,,13356,A
20200609,MT,53184,1592,554,6,52630,1586,18,0,72,5,3,,,,,485,C
20200609,NC,535711,15598,37160,676,498551,14922,1029,23,,774,0,,,,,23653,A
20200609,ND,80666,486,2901,21,77765,465,65,3,189,32,5,,,,,2450,D
20200609,NE,122692,1285,15752,118,106940,1167,188,0,967,176,32,,,,,8637,D
20200609,NH,87123,1571,5079,36,82044,1535,286,0,492,78,3,,145,,,3392,B
20200609,NJ,989497,14408,164796,299,824701,14109,12303,89,18069,1736,19,510,,373,,28036,A+
20200609,NM,238801,4426,9062,122,229739,4304,400,4,1558,183,25,,,,,3380,C
20200609,NV,183589,3586,10030,244,173559,3342,472,3,,350,0,86,,41,,557,A+
20200609,NY,2605869,49973,379482,683,2226387,49290,24348,49,89995,2344,0,663,,485,,67808,A
20200609,OH,490390,13572,39162,325,451228,13247,2421,17,6620,639,70,238,1708,153,,,B
20200609,OK,234041,12238,7363,158,226678,12080,353,5,1061,148,22,66,,,,6073,A+
20200609,OR,153617,3738,4988,66,148629,3672,169,5,851,145,8,47,,20,,2313,A+
20200609,PA,536304,8354,77056,493,459248,7861,6014,61,,1032,0,,,237,,53670,A+
20200609,PR,93870,139,5185,139,88685,0,142,0,,95,0,9,,6,,,B
20200609,RI,126339,1232,15751,68,110588,1164,808,9,1815,144,8,31,,19,,1398,A+
20200609,SC,247982,3321,15228,428,232754,2893,568,11,1898,541,84,,,,,7928,A+
20200609,SD,59159,1340,5523,52,53636,1288,68,3,487,90,5,,,,,4483,B
20200609,TN,521197,8434,27575,631,493622,7803,435,14,1974,587,26,,,,,18013,B
20200609,TX,1147355,27039,77253,1637,1070102,25402,1853,23,,2056,0,,,,,51140,B
20200609,UT,246860,3961,12559,237,234301,3724,127,3,931,230,13,,274,,116,7391,B
20200609,VA,390856,7264,51738,487,339118,6777,1496,19,7846,1169,116,311,,155,,6677,A+
20200609,VI,2208,9,71,0,2137,9,6,0,,,0,,,,,63,C
20200609,VT,44228,1430,1084,9,43144,1421,55,0,,16,0,,,,,901,B
20200609,WA,391090,9785,26004,272,365086,9513,1161,2,3699,205,30,,,60,,,B
20200609,WI,370944,14257,23734,300,347210,13957,661,15,2904,505,44,117,649,,,14583,A+
20200609,WV,114338,733,2169,16,112169,717,84,0,,24,0,9,,4,,1477,B
20200609,WY,30336,362,970,10,29366,352,17,0,91,8,0,,,,,789,C
20200608,AK,65912,1008,563,19,65349,989,10,0,,7,0,,,0,,384,B
20200608,AL,259991,425,20925,425,239066,0,718,26,2054,,32,,623,,371,11395,B
20200608,AR,160587,314,9740,314,150847,0,155,1,844,171,0,,,46,143,6424,A
20200608,AS,174,0,0,0,174,0,0,0,,,0,,,,,,C
20200608,AZ,288081,6460,27678,789,260403,5671,1047,3,3911,1266,64,390,,246,,5639,A+
20200608,CA,2431190,68972,131319,2507,2299871,66465,4653,27,,4506,0,1301,,,,,B
20200608,CO,217484,4470,28001,153,189483,4317,1274,0,4485,322,5,,,,,4091,A
20200608,CT,308071,5717,44092,124,263979,5593,4084,13,9669,324,0,,,,,7284,B
20200608,DC,55766,1219,9389,57,46377,1162,491,2,,268,0,102,,72,,1143,A+
20200608,DE,69947,950,9972,30,59975,920,490,2,,113,0,,,,,5791,A
20200608,FL,1234550,18392,64904,966,1169646,17426,2798,12,11282,,67,,,,,,A
20200608,GA,549375,9491,52497,599,496878,8892,2208,28,8746,819,61,,1925,,,,A
20200608,GU,7729,266,179,0,7550,266,5,0,,,0,,,,,163,B
20200608,HI,55147,1092,675,2,54472,1090,17,0,84,,1,,,,,617,D
20200608,IA,193622,5430,21987,320,171635,5110,612,8,,265,0,85,,53,,13028,A+
20200608,ID,56041,0,3139,0,52902,0,83,0,260,23,0,8,99,,,2461,A
20200608,IL,1059597,16823,129139,1382,930458,15441,6102,198,,2496,0,713,,443,,,A
20200608,IN,309503,5240,37623,226,271880,5014,2316,13,6179,902,43,346,1325,130,,25608,A+
20200608,KS,119509,5856,10650,257,108859,5599,236,4,936,,19,,311,,136,625,A
20200608,KY,252857,3795,11476,189,241381,3606,472,2,2368,486,7,76,958,,,3359,B
20200608,LA,442602,8537,43050,234,399552,8303,2944,8,,582,0,,,71,,33904,B
20200608,MA,657269,4779,103626,190,553643,4589,7353,37,10425,1415,32,322,,209,,84621,A+
20200608,MD,371503,6700,58404,431,313099,6269,2776,27,9629,979,83,392,,,,4240,B
20200608,ME,61645,2676,2588,18,59057,2658,99,0,301,37,3,12,,7,,1891,B
20200608,MI,739164,12939,65104,135,674060,12804,5942,15,,661,0,249,,191,,42041,A+
20200608,MN,360912,7771,29436,448,331476,7323,1208,11,3401,452,34,198,1052,,,23657,A
20200608,MO,241461,4603,14734,181,226727,4422,819,10,,611,0,,,76,,,B
20200608,MP,7242,1,28,1,7214,0,2,0,,,0,,,,,19,D
20200608,MS,208212,4963,17768,498,190444,4465,837,20,2535,598,13,142,,83,,13356,A
20200608,MT,51592,4214,548,3,51044,4211,18,0,69,2,0,,,,,475,C
20200608,NC,520113,8887,36484,938,483629,7949,1006,10,,739,0,,,,,23653,A
20200608,ND,80180,247,2880,19,77300,228,62,3,184,29,1,,,,,2336,D
20200608,NE,121407,1638,15634,91,105773,1547,188,0,935,166,7,,,,,8455,D
20200608,NH,85552,1543,5043,24,80509,1519,286,3,489,86,2,,145,,,3392,B
20200608,NJ,975089,14664,164497,333,810592,14331,12214,38,18050,1740,0,498,,361,,27941,A+
20200608,NM,234375,5228,8940,140,225435,5088,396,4,1533,177,44,,,,,3307,C
20200608,NV,180003,4306,9786,137,170217,4169,469,4,,339,0,74,,44,,522,A+
20200608,NY,2555896,58054,378799,702,2177097,57352,24299,40,89995,2371,0,678,,507,,67687,A
20200608,OH,476818,7794,38837,361,437981,7433,2404,27,6550,644,53,245,1668,158,,,B
20200608,OK,221803,55,7205,55,214598,0,348,0,1039,158,13,65,,,,6014,A+
20200608,OR,149879,1479,4922,114,144957,1365,164,0,843,137,24,43,,18,,2237,A+
20200608,PA,527950,7565,76563,351,451387,7214,5953,10,,1174,0,,,268,,53670,A+
20200608,PR,93731,61,5046,61,88685,0,142,0,,107,0,8,,7,,,B
20200608,RI,125107,929,15683,45,109424,884,799,27,1807,146,32,28,,20,,1390,A+
20200608,SC,244661,6802,14800,514,229861,6288,557,11,1814,507,0,,,,,7347,A+
20200608,SD,57819,759,5471,33,52348,726,65,0,482,92,4,,,,,4403,B
20200608,TN,512763,13995,26944,563,485819,13432,421,3,1948,617,16,,,,,17563,B
20200608,TX,1120316,19870,75616,638,1044700,19232,1830,0,,1935,0,,,,,49758,B
20200608,UT,242899,4948,12322,256,230577,4692,124,3,918,182,18,,270,,112,7255,B
20200608,VA,383592,3776,51251,570,332341,3206,1477,5,7730,1173,6,308,,160,,6557,A+
20200608,VI,2199,3,71,0,2128,3,6,0,,,0,,,,,62,C
20200608,VT,42798,1580,1075,12,41723,1568,55,0,,13,0,,,,,895,B
20200608,WA,381305,8276,25732,313,355573,7963,1159,6,3669,213,17,,,66,,,B
20200608,WI,356687,7608,23434,222,333253,7386,646,-1,2860,528,12,110,637,,,14242,A+
20200608,WV,113605,1798,2153,9,111452,1789,84,0,,24,0,9,,4,,1468,B
20200608,WY,29974,1223,960,13,29014,1210,17,0,91,7,1,,,,,773,C
20200607,AK,64904,1003,544,8,64360,995,10,0,,7,-48,,,1,,382,B
20200607,AL,259566,13922,20500,457,239066,13465,692,3,2022,,29,,615,,364,11395,B
20200607,AR,160273,3516,9426,325,150847,3191,154,0,844,145,6,,,35,143,6424,A
20200607,AS,174,0,0,0,174,0,0,0,,,0,,,,,,C
20200607,AZ,281621,9975,26889,1438,254732,8537,1044,2,3847,1252,70,392,,248,,5517,A+
20200607,CA,2362218,53918,128812,2796,2233406,51122,4626,67,,4525,0,1288,,,,,B
20200607,CO,213014,4737,27848,233,185166,4504,1274,0,4480,299,8,,,,,4074,A
20200607,CT,302354,6805,43968,150,258386,6655,4071,16,9669,333,0,,,,,7284,B
20200607,DC,54547,869,9332,63,45215,806,489,6,,285,0,90,,73,,1143,A+
20200607,DE,68997,1362,9942,97,59055,1265,488,3,,103,0,,,,,5792,A
20200607,FL,1216158,41973,63938,1180,1152220,40793,2786,13,11215,,52,,,,,,A
20200607,GA,539884,17027,51898,589,487986,16438,2180,6,8685,783,23,,1909,,,,A
20200607,GU,7463,0,179,0,7284,0,5,0,,,0,,,,,162,B
20200607,HI,54055,798,673,9,53382,789,17,0,83,,0,,,,,616,D
20200607,IA,188192,3478,21667,189,166525,3289,604,6,,269,0,86,,54,,12805,A+
20200607,ID,56041,802,3139,28,52902,774,83,0,260,30,3,8,99,,,2461,A
20200607,IL,1042774,20700,127757,867,915017,19833,5904,40,,2550,0,720,,438,,,A
20200607,IN,304263,6733,37397,400,266866,6333,2303,11,6136,913,45,335,1317,133,,25138,A+
20200607,KS,113653,0,10393,0,103260,0,232,0,917,,0,,306,,135,612,A
20200607,KY,249062,0,11287,0,237775,0,470,0,2361,495,0,75,958,,,3344,B
20200607,LA,434065,5996,42816,330,391249,5666,2936,11,,575,0,,,74,,31728,B
20200607,MA,652490,7851,103436,304,549054,7547,7316,27,10393,1442,24,335,,221,,84621,A+
20200607,MD,364803,7427,57973,491,306830,6936,2749,9,9546,1003,95,404,,,,4240,B
20200607,ME,58969,46,2570,46,56399,0,99,1,298,34,2,15,,7,,1864,B
20200607,MI,726225,10369,64969,55,661256,10314,5927,11,,864,0,315,,191,,42041,A+
20200607,MN,353141,9544,28988,135,324153,9409,1197,16,3367,450,31,199,1044,,,22992,A
20200607,MO,236858,6793,14553,111,222305,6682,809,0,,657,0,,,84,,,B
20200607,MP,7241,546,27,1,7214,545,2,0,,,0,,,,,19,D
20200607,MS,203249,10126,17270,501,185979,9625,817,14,2522,585,47,133,,69,,11203,A
20200607,MT,47378,624,545,5,46833,619,18,0,69,2,1,,,,,475,C
20200607,NC,511226,13876,35546,921,475680,12955,996,4,,696,0,,,,,18860,A
20200607,ND,79933,1053,2861,45,77072,1008,59,0,183,28,1,,,,,2307,D
20200607,NE,119769,2222,15543,164,104226,2058,188,2,928,167,9,,,,,8255,D
20200607,NH,84009,0,5019,0,78990,0,283,0,487,84,0,,145,,,3319,B
20200607,NJ,960425,40977,164164,271,796261,40706,12176,70,18050,1882,27,503,,385,,27824,A+
20200607,NM,229147,4507,8800,128,220347,4379,392,5,1489,176,0,,,,,3286,C
20200607,NV,175697,3926,9649,189,166048,3737,465,2,,348,0,80,,44,,522,A+
20200607,NY,2497842,60435,378097,781,2119745,59654,24259,47,89995,2427,0,704,,534,,67544,A
20200607,OH,469024,10498,38476,365,430548,10133,2377,7,6497,603,37,240,1657,167,,,B
20200607,OK,221748,147,7150,147,214598,0,348,3,1026,158,0,65,,,,5981,A+
20200607,OR,148400,2241,4808,146,143592,2095,164,1,819,121,0,39,,16,,2237,A+
20200607,PA,520385,9557,76212,506,444173,9051,5943,12,,1174,0,,,268,,53670,A+
20200607,PR,93670,70,4985,70,88685,0,142,0,,105,0,6,,7,,,B
20200607,RI,124178,807,15638,49,108540,758,772,0,1775,182,0,37,,23,,1336,A+
20200607,SC,237859,5115,14286,370,223573,4745,546,1,1814,477,0,,,,,7347,A+
20200607,SD,57060,1602,5438,71,51622,1531,65,0,478,87,4,,,,,4335,B
20200607,TN,498768,7347,26381,310,472387,7037,418,1,1932,561,9,,,,,17222,B
20200607,TX,1100446,7169,74978,1425,1025468,5744,1830,11,,1878,0,,,,,49758,B
20200607,UT,237951,2802,12066,268,225885,2534,121,0,900,207,10,,269,,111,7108,B
20200607,VA,379816,8685,50681,1284,329135,7401,1472,12,7724,1186,171,316,,165,,6538,A+
20200607,VI,2196,0,71,0,2125,0,6,0,,,0,,,,,62,C
20200607,VT,41218,1135,1063,17,40155,1118,55,0,,14,0,,,,,890,B
20200607,WA,373029,2372,25419,192,347610,2180,1153,4,3652,205,13,,,57,,,B
20200607,WI,349079,11340,23212,275,325867,11065,647,2,2848,491,16,107,638,,,14047,A+
20200607,WV,111807,2084,2144,13,109663,2071,84,0,,28,0,9,,4,,1451,B
20200607,WY,28751,243,947,8,27804,235,17,0,90,4,0,,,,,757,C
20200606,AK,63901,2911,536,12,63365,2899,10,0,48,7,48,,,1,,382,A
20200606,AL,245644,6171,20043,656,225601,5515,689,13,1993,,44,,612,,363,11395,B
20200606,AR,156757,9146,9101,450,147656,8696,154,2,838,154,46,,,36,142,6266,A
20200606,AS,174,0,0,0,174,0,0,0,,,0,,,,,,C
20200606,AZ,271646,7781,25451,1119,246195,6662,1042,30,3777,1278,65,391,,292,,5399,A+
20200606,CA,2308300,69837,126016,3115,2182284,66722,4559,74,,4526,0,1315,,,,,B
20200606,CO,208277,4853,27615,255,180662,4598,1274,19,4472,299,12,,,,,4055,A
20200606,CT,295549,8162,43818,358,251731,7804,4055,17,9669,333,0,,,,,7284,B
20200606,DC,53678,1817,9269,70,44409,1747,483,8,,276,0,100,,68,,1138,A+
20200606,DE,67635,906,9845,72,57790,834,485,0,,117,0,,,,,5696,A
20200606,FL,1174185,39245,62758,1270,1111427,37975,2773,28,11163,,97,,,,,,A
20200606,GA,522857,15069,51309,688,471548,14381,2174,0,8662,788,16,,1901,,,,A
20200606,GU,7463,89,179,0,7284,89,5,0,,,0,,,,,162,B
20200606,HI,53257,921,664,9,52593,912,17,0,83,,0,,,,,614,D
20200606,IA,184714,4051,21478,326,163236,3725,598,6,,299,0,102,,62,,12715,A+
20200606,ID,55239,1615,3111,57,52128,1558,83,0,257,21,2,8,98,,,2408,A
20200606,IL,1022074,21155,126890,975,895184,20180,5864,69,,2702,0,770,,476,,,A
20200606,IN,297530,5892,36997,419,260533,5473,2292,34,6091,926,38,344,1304,133,,24729,A+
20200606,KS,113653,0,10393,0,103260,0,232,0,917,,0,,306,,135,612,A
20200606,KY,249062,6645,11287,310,237775,6335,470,4,2361,495,16,75,958,,,3344,B
20200606,LA,428069,7283,42486,497,385583,6786,2925,13,,582,0,,,77,,31728,B
20200606,MA,644639,9870,103132,575,541507,9295,7289,54,10369,1529,66,359,,238,,84621,A+
20200606,MD,357376,9650,57482,712,299894,8938,2740,38,9451,1059,105,418,,,,4175,B
20200606,ME,58923,1391,2524,42,56399,1349,98,0,296,35,3,14,,7,,1845,B
20200606,MI,715856,10585,64914,93,650942,10492,5916,7,,864,0,315,,191,,42041,A+
20200606,MN,343597,10412,28853,165,314744,10247,1181,22,3336,473,47,206,1044,,,22253,A
20200606,MO,230065,5523,14442,189,215623,5334,809,10,,666,0,,,79,,,B
20200606,MP,6695,0,26,0,6669,0,2,0,,,0,,,,,16,D
20200606,MS,193123,10,16769,10,176354,0,803,0,2475,604,0,149,,84,,11203,A
20200606,MT,46754,866,540,-1,46214,867,18,0,68,1,0,,,,,472,C
20200606,NC,497350,15203,34625,1370,462725,13833,992,26,,708,0,,,,,18860,A
20200606,ND,78880,2024,2816,71,76064,1953,59,0,182,29,2,,,,,2268,D
20200606,NE,117547,2725,15379,262,102168,2463,186,0,919,181,14,,,,,7957,D
20200606,NH,84009,4244,5019,143,78990,4101,283,10,487,84,15,,145,,,3319,B
20200606,NJ,919448,557,163893,557,755555,0,12106,57,18023,1933,143,539,,410,,27641,A+
20200606,NM,224640,6883,8672,319,215968,6564,387,4,1489,175,73,,,,,3206,C
20200606,NV,171771,5664,9460,194,162311,5470,463,3,,348,0,80,,44,,522,A+
20200606,NY,2437407,77895,377316,1108,2060091,76787,24212,37,89995,2603,0,720,,554,,67261,A
20200606,OH,458526,12331,38111,353,420415,11978,2370,15,6460,628,75,256,1650,155,,,B
20200606,OK,221601,5130,7003,96,214598,5034,345,1,1026,158,12,65,,,,5867,A+
20200606,OR,146159,2913,4662,92,141497,2821,163,2,819,121,0,39,,16,,2237,A+
20200606,PA,510828,11622,75706,701,435122,10921,5931,45,,1174,0,,,268,,52560,A+
20200606,PR,93600,28558,4915,295,88685,28263,142,1,,100,0,7,,4,,,B
20200606,RI,123371,1194,15589,68,107782,1126,772,0,1775,182,0,37,,23,,1336,A+
20200606,SC,232744,1445,13916,463,218828,982,545,7,1814,453,0,,,,,7347,A+
20200606,SD,55458,2095,5367,90,50091,2005,65,0,474,93,7,,,,,4273,B
20200606,TN,491421,9249,26071,551,465350,8698,417,9,1923,535,30,,,,,17124,B
20200606,TX,1093277,31701,73553,1940,1019724,29761,1819,31,,1822,0,,,,,48895,B
20200606,UT,235149,2952,11798,546,223351,2406,121,1,890,147,20,,266,,110,6939,B
20200606,VA,371131,7361,49397,865,321734,6496,1460,7,7553,1171,-44,324,,169,,6382,A+
20200606,VI,2196,145,71,0,2125,145,6,0,,,0,,,,,62,C
20200606,VT,40083,966,1046,19,39037,947,55,0,,16,0,,,,,888,B
20200606,WA,370657,3749,25227,204,345430,3545,1149,11,3639,247,24,,,86,,,B
20200606,WI,337739,11808,22937,338,314802,11470,645,12,2832,492,41,118,636,,,13770,A+
20200606,WV,109723,1205,2131,12,107592,1193,84,0,,27,0,11,,3,,1446,B
20200606,WY,28508,896,939,6,27569,890,17,0,90,4,0,,,,,757,C
20200605,AK,60990,893,524,11,60466,882,10,0,,8,0,,,1,,380,A
20200605,AL,239473,4174,19387,315,220086,3859,676,23,1949,,20,,603,,358,11395,B
20200605,AR,147611,5131,8651,584,138960,4547,152,10,792,147,35,,,32,138,5919,A
20200605,AS,174,0,0,0,174,0,0,0,,,0,,,,,,C
20200605,AZ,263865,14110,24332,1579,239533,12531,1012,16,3712,1234,70,375,,241,,5298,A+
20200605,CA,2238463,55792,122901,3094,2115562,52698,4485,63,,4625,0,1333,,,,,B
20200605,CO,203424,6224,27360,300,176064,5924,1255,1,4460,319,17,,,,,4034,A
20200605,CT,287387,5862,43460,221,243927,5641,4038,31,9669,350,0,,,,,7284,B
20200605,DC,51861,765,9199,79,42662,686,475,0,,273,0,99,,75,,1138,A+
20200605,DE,66729,820,9773,27,56956,793,485,2,,128,0,,,,,5631,A
20200605,FL,1134940,27897,61488,1305,1073452,26592,2745,54,11066,,143,,,,,,A
20200605,GA,507788,11457,50621,774,457167,10683,2174,27,8646,790,89,,1897,,,,A
20200605,GU,7374,390,179,0,7195,390,5,0,,,0,,,,,162,B
20200605,HI,52336,1698,655,2,51681,1696,17,0,83,,0,,,,,611,D
20200605,IA,180663,5728,21152,347,159511,5381,592,12,,299,0,102,,62,,12585,A+
20200605,ID,53624,3819,3054,64,50570,3755,83,0,255,29,2,8,98,,,2362,A
20200605,IL,1000919,18903,125915,1156,875004,17747,5795,59,,2911,0,817,,500,,,A
20200605,IN,291638,6404,36578,482,255060,5922,2258,27,6053,924,54,368,1293,147,,24317,A+
20200605,KS,113653,5600,10393,223,103260,5377,232,10,917,,27,,306,,135,612,A
20200605,KY,242417,6492,10977,272,231440,6220,466,8,2345,505,13,73,958,,,3316,B
20200605,LA,420786,9600,41989,427,378797,9173,2912,29,,604,0,,,75,,31728,B
20200605,MA,634769,9834,102557,494,532212,9340,7235,34,10303,1533,65,350,,238,,84621,A+
20200605,MD,347726,10708,56770,912,290956,9796,2702,34,9346,1076,129,455,,,,4159,B
20200605,ME,57532,1331,2482,36,55050,1295,98,3,293,35,2,13,,7,,1797,B
20200605,MI,705271,12748,64821,205,640450,12543,5909,8,,617,0,321,,205,,38099,A+
20200605,MN,333185,11037,28688,398,304497,10639,1159,33,3289,478,36,220,1044,,,21864,A
20200605,MO,224542,5881,14253,196,210289,5685,799,13,,666,0,,,79,,,B
20200605,MP,6695,0,26,0,6669,0,2,0,,,0,,,,,16,D
20200605,MS,193113,8128,16759,199,176354,7929,803,9,2475,604,135,149,,84,,11203,A
20200605,MT,45888,1246,541,2,45347,1244,18,1,68,1,0,,,,,470,C
20200605,NC,482147,13845,33255,1289,448892,12556,966,6,,717,0,,,,,18860,A
20200605,ND,76856,1112,2745,39,74111,1073,59,1,180,30,5,,,,,2242,D
20200605,NE,114822,2567,15117,251,99705,2316,186,-1,905,190,3,,,,,7598,D
20200605,NH,79765,3800,4876,81,74889,3719,273,8,472,86,4,,145,,,3187,B
20200605,NJ,918891,61162,163336,806,755555,60356,12049,79,17880,1933,276,542,,410,,27433,A+
20200605,NM,217757,4761,8353,213,209404,4548,383,8,1416,170,0,,,,,3115,C
20200605,NV,166107,4684,9266,176,156841,4508,460,0,,341,0,72,,47,,522,A+
20200605,NY,2359512,66480,376208,1075,1983304,65405,24175,42,89995,2728,0,758,,583,,66992,A
20200605,OH,446195,8944,37758,476,408437,8468,2355,16,6385,671,73,259,1632,168,,,B
20200605,OK,216471,4749,6907,0,209564,4749,344,0,1014,164,0,66,,,,5781,A+
20200605,OR,143246,3934,4570,96,138676,3838,161,2,819,121,7,39,,16,,2214,A+
20200605,PA,499206,7704,75005,445,424201,7259,5886,69,,1174,0,,,268,,52069,A+
20200605,PR,65042,112,4620,112,60422,0,141,1,,116,0,9,,7,,,B
20200605,RI,122177,1625,15521,105,106656,1520,772,16,1775,182,10,37,,23,,1336,A+
20200605,SC,231299,448,13453,448,217846,0,538,13,1814,453,25,,,,,7347,A+
20200605,SD,53363,741,5277,30,48086,711,65,1,467,83,3,,,,,4179,B
20200605,TN,482172,6034,25520,400,456652,5634,408,7,1893,505,38,,,,,16925,B
20200605,TX,1061576,23021,71613,1693,989963,21328,1788,21,,1855,0,,,,,47865,B
20200605,UT,232197,4690,11252,439,220945,4251,120,3,870,133,20,,262,,109,6788,B
20200605,VA,363770,10180,48532,676,315238,9504,1453,8,7597,1205,47,320,,161,,6392,A+
20200605,VI,2051,5,71,0,1980,5,6,0,,,0,,,,,62,C
20200605,VT,39117,1283,1027,1,38090,1282,55,0,,14,0,,,,,882,B
20200605,WA,366908,6259,25023,346,341885,5913,1138,3,3615,285,37,,,91,,,B
20200605,WI,325931,12371,22599,406,303332,11965,633,7,2791,526,52,124,625,,,13337,A+
20200605,WV,108518,2469,2119,27,106399,2442,84,6,,27,0,11,,3,,1445,B
20200605,WY,27612,623,933,18,26679,605,17,0,90,4,3,,,,,755,C
20200604,AK,60097,1915,513,8,59584,1907,10,0,,13,0,,,1,,376,A
20200604,AL,235299,3705,19072,221,216227,3484,653,0,1929,,29,,601,,357,11395,B
20200604,AR,142480,0,8067,0,134413,0,142,0,757,138,26,,,30,127,5717,A
20200604,AS,174,0,0,0,174,0,0,0,,,0,,,,,,C
20200604,AZ,249755,5230,22753,520,227002,4710,996,15,3642,1079,53,375,,223,,5172,A+
20200604,CA,2182671,51377,119807,2120,2062864,49257,4422,61,,4455,0,1279,,,,,B
20200604,CO,197200,3023,27060,272,170140,2751,1254,26,4443,356,24,,,,,4014,A
20200604,CT,281525,5089,43239,148,238286,4941,4007,18,9669,373,-4124,,,,,7284,B
20200604,DC,51096,1534,9120,104,41976,1430,475,2,,276,0,98,,73,,1138,A+
20200604,DE,65909,989,9746,34,56163,955,483,8,,142,0,,,,,5562,A
20200604,FL,1107043,26130,60183,1419,1046860,24711,2691,41,10923,,127,,,,,,A
20200604,GA,496331,13619,49847,953,446484,12666,2147,24,8557,807,138,,1872,,,,A
20200604,GU,6984,257,179,1,6805,256,5,0,,,0,,,,,162,B
20200604,HI,50638,1130,653,0,49985,1130,17,0,83,,0,,,,,612,D
20200604,IA,174935,10490,20805,750,154130,9740,580,6,,310,0,105,,70,,12333,A+
20200604,ID,49805,863,2990,57,46815,806,83,0,253,28,2,3,98,,,2311,A
20200604,IL,982016,22841,124759,929,857257,21912,5736,115,,3044,0,853,,516,,,A
20200604,IN,285234,7419,36096,384,249138,7035,2231,24,5999,979,47,372,1286,144,,23707,A+
20200604,KS,108053,0,10170,0,97883,0,222,0,890,,0,,302,,131,592,A
20200604,KY,235925,3726,10705,295,225220,3431,458,8,2332,518,15,67,954,,,3303,B
20200604,LA,411186,9099,41562,429,369624,8670,2883,13,,613,0,,,82,,31728,B
20200604,MA,624935,7174,102063,471,522872,6703,7201,49,10238,1637,87,401,,249,,84621,A+
20200604,MD,337018,9393,55858,876,281160,8517,2668,2,9217,1096,106,456,,,,3985,B
20200604,ME,56201,3192,2446,28,53755,3164,95,0,291,35,6,14,,7,,1739,B
20200604,MI,692523,14968,64616,234,627907,14734,5901,17,,617,0,321,,205,,38099,A+
20200604,MN,322148,10940,28290,401,293858,10539,1126,29,3253,512,50,244,1033,,,21490,A
20200604,MO,218661,7308,14057,290,204604,7018,786,0,,599,0,,,82,,,B
20200604,MP,6695,138,26,3,6669,135,2,0,,,0,,,,,16,D
20200604,MS,184985,238,16560,238,168425,0,794,12,2340,633,0,145,,97,,11203,A
20200604,MT,44642,1194,539,14,44103,1180,17,0,68,1,0,,,,,467,C
20200604,NC,468302,19039,31966,1189,436336,17850,960,21,,659,0,,,,,18860,A
20200604,ND,75744,1242,2706,27,73038,1215,58,4,175,32,3,,,,,2209,D
20200604,NE,112255,2289,14866,255,97389,2034,187,6,902,211,51,,,,,7005,D
20200604,NH,75965,226,4795,46,71170,180,265,9,468,88,6,,144,,,3157,B
20200604,NJ,857729,20309,162530,462,695199,19847,11970,90,17604,1982,214,537,,459,,27231,A+
20200604,NM,212996,6159,8140,116,204856,6043,375,8,1416,170,0,,,,,3013,C
20200604,NV,161423,5168,9090,155,152333,5013,460,5,,364,0,79,,47,,512,A+
20200604,NY,2293032,63559,375133,1048,1917899,62511,24133,54,89995,2849,0,832,,613,,66756,A
20200604,OH,437251,11146,37282,490,399969,10656,2339,40,6312,693,61,267,1623,181,,,B
20200604,OK,211722,3670,6907,102,204815,3568,344,3,1014,148,11,63,,,,5781,A+
20200604,OR,139312,2644,4474,75,134838,2569,159,0,812,124,12,40,,13,,2199,A+
20200604,PA,491502,16111,74560,538,416942,15573,5817,76,,1174,0,,,268,,51019,A+
20200604,PR,64930,485,4508,485,60422,0,140,0,,114,0,15,,9,,,B
20200604,RI,120552,2117,15416,117,105136,2000,756,14,1765,185,12,42,,29,,1326,A+
20200604,SC,230851,7926,13005,354,217846,7572,525,7,1789,453,0,,,,,6976,A+
20200604,SD,52622,3960,5247,85,47375,3875,64,2,464,86,8,,,,,4163,B
20200604,TN,476138,5359,25120,298,451018,5061,401,13,1855,547,26,,,,,16643,B
20200604,TX,1038555,31787,69920,1649,968635,30138,1767,33,,1796,0,,,,,46799,B
20200604,UT,227507,3526,10813,316,216694,3210,117,0,850,164,21,,258,,108,6628,B
20200604,VA,353590,11203,47856,951,305734,10252,1445,17,7550,1266,74,321,,171,,6284,A+
20200604,VI,2046,20,71,1,1975,19,6,0,,,0,,,,,62,C
20200604,VT,37834,639,1026,36,36808,603,55,0,,13,0,,,,,881,B
20200604,WA,360649,4589,24677,292,335972,4297,1135,6,3578,272,35,,,94,,,B
20200604,WI,313560,12188,22193,532,291367,11656,626,10,2739,551,39,117,616,,,12980,A+
20200604,WV,106049,2281,2092,21,103957,2260,78,0,,28,0,11,,2,,1399,B
20200604,WY,26989,361,915,0,26074,361,17,0,87,4,0,,,,,714,C
20200603,AK,58182,1979,505,18,57677,1961,10,0,,11,0,,,0,,373,A
20200603,AL,231594,7792,18851,209,212743,7583,653,2,1900,,21,,591,,355,11395,B
20200603,AR,142480,9244,8067,624,134413,8620,142,9,731,132,13,,,31,124,5717,A
20200603,AS,174,0,0,0,174,0,0,0,,,0,,,,,,C
20200603,AZ,244525,6692,22233,983,222292,5709,981,40,3589,1092,69,379,,239,,5076,A+
20200603,CA,2131294,59703,117687,2377,2013607,57326,4361,75,,4458,0,1313,,,,,B
20200603,CO,194177,3640,26788,211,167389,3429,1228,43,4419,388,47,,,,,3983,A
20200603,CT,276436,5826,43091,112,233345,5714,3989,17,13793,406,0,,,,,7511,B
20200603,DC,49562,1861,9016,130,40546,1731,473,3,,285,0,103,,72,,1138,A+
20200603,DE,64920,858,9712,27,55208,831,475,4,,153,0,,,,,5493,A
20200603,FL,1080913,31161,58764,1317,1022149,29844,2650,37,10796,,118,,,,,,B
20200603,GA,482712,8425,48894,687,433818,7738,2123,21,8419,815,85,,1841,,,,B
20200603,GU,6727,336,178,1,6549,335,5,0,,,0,,,,,151,B
20200603,HI,49508,587,653,1,48855,586,17,0,83,,0,,,,,609,D
20200603,IA,164445,755,20055,39,144390,716,574,13,,314,0,116,,76,,12064,A+
20200603,ID,48942,809,2933,27,46009,782,83,0,251,30,4,3,98,,,2282,A
20200603,IL,959175,24471,123830,982,835345,23489,5621,96,,3173,0,844,,508,,,A
20200603,IN,277815,5896,35712,475,242103,5421,2207,10,5952,1017,50,358,1282,138,,23182,A+
20200603,KS,108053,4741,10170,159,97883,4582,222,5,890,,28,,302,,131,592,A
20200603,KY,232199,4928,10410,225,221789,4703,450,8,2317,488,10,68,950,,,3283,B
20200603,LA,402087,8954,41133,387,360954,8567,2870,35,,617,0,,,86,,31728,B
20200603,MA,617761,8366,101592,429,516169,7937,7152,67,10151,1684,88,393,,263,,78108,A+
20200603,MD,327625,11810,54982,807,272643,11003,2666,20,9111,1109,154,471,,,,3970,B
20200603,ME,53009,41,2418,41,50591,0,95,1,285,44,-2,14,,10,,1699,B
20200603,MI,677555,16380,64382,279,613173,16101,5884,15,,646,0,328,,224,,38099,A+
20200603,MN,311208,15901,27889,513,283319,15388,1097,15,3203,537,69,254,1022,,,21169,A
20200603,MO,211353,5923,13767,192,197586,5731,786,3,,571,0,,,70,,,B
20200603,MP,6557,0,23,0,6534,0,2,0,,,0,,,,,16,D
20200603,MS,184747,5249,16322,302,168425,4947,782,15,2340,602,44,141,,96,,11203,A
20200603,MT,43448,1236,525,2,42923,1234,17,0,68,1,1,,,,,464,C
20200603,NC,449263,14342,30777,888,418486,13454,939,18,,684,0,,,,,18860,A
20200603,ND,74502,858,2679,33,71823,825,54,0,172,34,2,,,,,2169,C
20200603,NE,109966,3548,14611,266,95355,3282,181,3,851,194,851,,,,,6743,C
20200603,NH,75739,1395,4749,64,70990,1331,256,11,462,97,6,,142,,,3071,B
20200603,NJ,837420,19743,162068,523,675352,19220,11880,110,17390,2250,0,612,,459,,27008,A+
20200603,NM,206837,3722,8024,224,198813,3498,367,5,1416,182,99,,,,,2960,C
20200603,NV,156255,4164,8935,105,147320,4059,455,3,,372,0,84,,47,,501,A+
20200603,NY,2229473,61642,374085,1045,1855388,60597,24079,56,89995,2978,134,865,,638,,66502,A
20200603,OH,426105,16197,36792,442,389313,15755,2299,41,6251,704,75,283,1604,198,,,B
20200603,OK,208052,3395,6805,113,201247,3282,341,2,1003,136,9,59,,,,5711,A+
20200603,OR,136668,2459,4399,64,132269,2395,159,2,800,112,5,27,,10,,2199,A+
20200603,PA,475391,2520,74022,512,401369,2008,5741,74,,1164,0,,,269,,49915,A+
20200603,PR,64445,88,4023,88,60422,0,140,2,,107,0,12,,7,,,B
20200603,RI,118435,1729,15299,105,103136,1624,742,10,1753,189,10,44,,30,,1311,A+
20200603,SC,222925,4148,12651,236,210274,3912,518,17,1789,433,0,,,,,6976,A+
20200603,SD,48662,1816,5162,95,43500,1721,62,0,456,87,13,,,,,4084,B
20200603,TN,470779,8643,24822,447,445957,8196,388,7,1829,548,37,,,,,16319,B
20200603,TX,1006768,20544,68271,1703,938497,18841,1734,36,,1487,0,,,,,45858,B
20200603,UT,223981,2190,10497,295,213484,1895,117,4,829,150,28,,250,,107,6501,B
20200603,VA,342387,13498,46905,666,295482,12832,1428,21,7476,1311,103,313,,185,,6165,A+
20200603,VI,2026,20,70,0,1956,20,6,0,,,0,,,,,62,C
20200603,VT,37195,576,990,2,36205,574,55,0,,10,0,,,,,879,B
20200603,WA,356060,5328,24385,299,331675,5029,1129,5,3543,263,26,,,89,,,B
20200603,WI,301372,16474,21661,506,279711,15968,616,9,2700,556,57,130,606,,,12172,A+
20200603,WV,103768,3225,2071,30,101697,3195,78,1,,34,0,13,,4,,1381,B
20200603,WY,26628,886,915,5,25713,881,17,0,87,4,1,,,,,714,C
20200602,AK,56203,2013,487,20,55716,1993,10,0,,10,0,,,0,,371,A
20200602,AL,223802,279,18642,279,205160,0,651,5,1879,,23,,591,,355,9355,B
20200602,AR,133236,0,7443,0,125793,0,133,0,718,121,7,,,26,124,5401,A
20200602,AS,174,0,0,0,174,0,0,0,,,0,,,,,,C
20200602,AZ,237833,9763,21250,1127,216583,8636,941,24,3520,1009,75,380,,235,,4967,A+
20200602,CA,2071591,59008,115310,2304,1956281,56704,4286,35,,4393,0,1286,,,,,B
20200602,CO,190537,4161,26577,199,163960,3962,1185,4,4372,394,25,,,,,3954,A
20200602,CT,270610,9220,42979,239,227631,8981,3972,8,13793,434,0,,,,,7511,B
20200602,DC,47701,438,8886,29,38815,409,470,2,,295,0,106,,74,,1137,A+
20200602,DE,64062,1615,9685,80,54377,1535,471,0,,157,0,,,,,5442,A
20200602,FL,1049752,9352,57447,617,992305,8735,2613,70,10678,,184,,,,,,A
20200602,GA,474287,2656,48207,589,426080,2067,2102,28,8334,828,207,,1821,,,,A
20200602,GU,6391,75,177,2,6214,73,5,0,,,0,,,,,148,B
20200602,HI,48921,434,652,0,48269,434,17,0,83,,0,,,,,608,D
20200602,IA,163690,4609,20016,319,143674,4290,561,10,,327,0,114,,76,,11742,A+
20200602,ID,48133,1436,2906,67,45227,1369,83,1,247,34,5,4,98,,,2266,A
20200602,IL,934704,16431,122848,1614,811856,14817,5525,113,,3238,0,874,,548,,,A
20200602,IN,271919,6023,35237,407,236682,5616,2197,55,5902,961,42,358,1261,140,,22623,A+
20200602,KS,103312,8071,10011,0,93301,8071,217,0,862,,20,,290,,127,555,A
20200602,KY,227271,11225,10185,139,217086,11086,442,3,2307,481,33,85,941,,,3275,A
20200602,LA,393133,5763,40746,405,352387,5358,2835,34,,639,0,,,83,,31728,B
20200602,MA,609395,5962,101163,358,508232,5604,7085,50,10063,1657,111,394,,269,,78108,A+
20200602,MD,315815,7085,54175,848,261640,6237,2646,21,8957,1148,71,481,,,,3855,B
20200602,ME,52968,3335,2377,28,50591,3307,94,5,287,48,3,16,,10,,1646,B
20200602,MI,661175,15938,64103,290,597072,15648,5869,26,,674,0,346,,240,,38099,A+
20200602,MN,295307,7671,27376,479,267931,7192,1082,22,3134,537,48,248,1003,,,20381,A
20200602,MO,205430,5722,13575,248,191855,5474,783,10,,693,0,,,81,,,B
20200602,MP,6557,223,23,1,6534,222,2,0,,,0,,,,,16,D
20200602,MS,179498,3244,16020,268,163478,2976,767,28,2296,584,0,146,,97,,11203,A
20200602,MT,42212,1555,523,4,41689,1551,17,0,67,1,0,,,,,462,C
20200602,NC,434921,13013,29889,626,405032,12387,921,23,,716,0,,,,,18860,A
20200602,ND,73644,343,2646,21,70998,322,54,4,170,34,1,,,,,2127,C
20200602,NE,106418,2753,14345,244,92073,2509,178,8,,,0,,,,,,D
20200602,NH,74344,1888,4685,34,69659,1854,245,0,456,98,5,,142,,,2954,B
20200602,NJ,817677,22077,161545,627,656132,21450,11770,49,17390,2370,168,639,,480,,26815,A+
20200602,NM,203115,3511,7800,111,195315,3400,362,6,1317,191,0,,,,,2888,C
20200602,NV,152091,5308,8830,142,143261,5166,452,7,,365,0,88,,39,,464,A+
20200602,NY,2167831,54054,373040,1329,1794791,52725,24023,64,89861,3121,158,907,,673,,66262,A
20200602,OH,409908,11842,36350,366,373558,11476,2258,52,6176,697,64,295,1583,204,,,B
20200602,OK,204657,11384,6692,119,197965,11265,339,5,994,124,8,60,,,,5599,A+
20200602,OR,134209,2591,4335,33,129874,2558,157,3,795,102,5,29,,15,,2164,A+
20200602,PA,472871,10542,73510,612,399361,9930,5667,100,,1302,0,,,283,,48838,A+
20200602,PR,64357,62,3935,62,60422,0,138,2,,106,0,17,,10,,,B
20200602,RI,116706,1507,15194,107,101512,1400,732,12,1743,188,19,48,,31,,1302,A+
20200602,SC,218777,14089,12415,267,206362,13822,501,1,1789,425,155,,,,,6976,A
20200602,SD,46846,1185,5067,33,41779,1152,62,0,443,89,8,,,,,3990,B
20200602,TN,462136,13643,24375,821,437761,12822,381,14,1792,565,25,,,,,15916,B
20200602,TX,986224,16193,66568,1688,919656,14505,1698,20,,1773,0,,,,,44517,B
20200602,UT,221791,3679,10202,203,211589,3476,113,0,801,159,12,,243,,104,6319,B
20200602,VA,328889,4170,46239,841,282650,3329,1407,15,7373,1362,47,336,,186,,6011,A+
20200602,VI,2006,195,70,0,1936,195,6,0,,,0,,,,,62,C
20200602,VT,36619,1293,988,5,35631,1288,55,0,,10,0,,,,,879,B
20200602,WA,350732,6407,24086,288,326646,6119,1124,6,3517,232,16,,,48,,,B
20200602,WI,284898,10567,21155,419,263743,10148,607,12,2643,597,40,139,593,,,12172,A+
20200602,WV,100543,2448,2041,24,98502,2424,77,2,,31,0,11,,4,,1341,B
20200602,WY,25742,595,910,0,24832,595,17,0,86,7,0,,,,,667,C
20200601,AK,54190,2495,467,33,53723,2462,10,0,,10,0,,,1,,368,A
20200601,AL,223523,5970,18363,460,205160,5510,646,15,1856,,12,,591,,355,9355,B
20200601,AR,133236,3721,7443,190,125793,3531,133,0,711,115,0,,,27,123,5401,A
20200601,AS,174,0,0,0,174,0,0,0,,,0,,,,,,C
20200601,AZ,228070,2864,20123,187,207947,2677,917,11,3445,968,66,377,,238,,4869,A+
20200601,CA,2012583,67735,113006,2423,1899577,65312,4251,38,,4258,0,1273,,,,,B
20200601,CO,186376,5749,26378,280,159998,5469,1181,0,4347,414,14,,,,,3919,A
20200601,CT,261390,11344,42740,539,218650,10805,3964,20,13793,454,1255,,,,,7511,B
20200601,DC,47263,780,8857,56,38406,724,468,2,,302,0,108,,67,,1126,A+
20200601,DE,62447,1776,9605,107,52842,1669,471,3,,159,0,,,,,5353,A
20200601,FL,1040400,19051,56830,667,983570,18384,2543,9,10494,,41,,,,,,A
20200601,GA,471631,6106,47618,632,424013,5474,2074,32,8127,841,181,,1800,,,,A
20200601,GU,6316,214,175,2,6141,212,5,0,,,0,,,,,145,B
20200601,HI,48487,-6133,652,1,47835,-6134,17,0,83,,0,,,,,608,D
20200601,IA,159081,2785,19697,145,139384,2640,551,17,,339,0,125,,73,,11440,A+
20200601,ID,46697,0,2839,0,43858,0,82,0,242,25,0,3,96,,,2248,A
20200601,IL,918273,20014,121234,974,797039,19040,5412,22,,3215,0,902,,547,,,A
20200601,IN,265896,4350,34830,256,231066,4094,2142,8,5860,1041,575,366,1255,148,,22224,A+
20200601,KS,95241,292,10011,292,85230,0,217,9,842,,0,,284,,124,547,A
20200601,KY,216046,2293,10046,342,206000,1951,439,8,2274,457,2,90,940,,,3232,A
20200601,LA,387370,12261,40341,425,347029,11836,2801,10,,661,0,,,86,,31728,B
20200601,MA,603433,10580,100805,3840,502628,6740,7035,189,9952,1747,129,404,,289,,78108,A
20200601,MD,308730,6849,53327,549,255403,6300,2625,29,8886,1174,148,479,,,,3782,B
20200601,ME,49633,24,2349,24,47284,0,89,0,284,52,1,17,,10,,1586,B
20200601,MI,645237,14477,63813,245,581424,14232,5843,25,,674,0,346,,240,,38099,A+
20200601,MN,287636,4181,26897,575,260739,3606,1060,10,3086,549,39,253,981,,,19441,A
20200601,MO,199708,6147,13327,180,186381,5967,773,1,,693,0,,,78,,,B
20200601,MP,6334,161,22,0,6312,161,2,0,,,0,,,,,16,D
20200601,MS,176254,4417,15752,251,160502,4166,739,5,2296,584,24,146,,97,,11203,A
20200601,MT,40657,859,519,4,40138,855,17,0,67,2,0,,,,,461,C
20200601,NC,421908,5619,29263,674,392645,4945,898,12,,650,0,,,,,18860,A
20200601,ND,73301,1261,2625,48,70676,1213,50,2,169,35,2,,,,,2078,C
20200601,NE,103665,2523,14101,196,89564,2327,170,0,,,0,,,,,,D
20200601,NH,72456,2176,4651,106,67805,2070,245,3,451,96,2,,141,,,2948,B
20200601,NJ,795600,49455,160918,473,634682,48982,11721,23,17222,2466,25,646,,459,,26703,A+
20200601,NM,199604,5157,7689,65,191915,5092,356,5,1317,182,0,,,,,2853,C
20200601,NV,146783,4223,8688,95,138095,4128,445,1,,361,0,87,,40,,459,A+
20200601,NY,2113777,49952,371711,941,1742066,49011,23959,54,89703,3331,113,999,,746,,66110,A
20200601,OH,398066,7158,35984,471,362082,6687,2206,51,6112,761,63,324,1569,223,,,B
20200601,OK,193273,67,6573,67,186700,0,334,0,986,154,1,65,,,,5511,A+
20200601,OR,131618,2417,4302,59,127316,2358,154,1,790,108,4,32,,17,,2164,A+
20200601,PA,462329,6672,72898,352,389431,6320,5567,12,,1302,0,,,287,,48428,A+
20200601,PR,64295,97,3873,97,60422,0,136,0,,99,0,9,,4,,,B
20200601,RI,115199,1421,15087,99,100112,1322,720,2,1724,195,23,46,,29,,1281,A+
20200601,SC,204688,4472,12148,287,192540,4185,500,6,1634,450,0,,,,,6459,A
20200601,SD,45661,1533,5034,41,40627,1492,62,0,435,87,3,,,,,3903,B
20200601,TN,448493,12516,23554,548,424939,11968,367,3,1767,504,17,,,,,15564,B
20200601,TX,970031,18166,64880,593,905151,17573,1678,6,,1756,0,,,,,43338,B
20200601,UT,218112,4198,9999,202,208113,3996,113,0,789,134,14,,242,,102,6251,B
20200601,VA,324719,9328,45398,791,279321,8537,1392,17,7326,1371,0,347,,188,,5899,A+
20200601,VI,1811,109,70,1,1741,108,6,0,,,0,,,,,62,C
20200601,VT,35326,1356,983,2,34343,1354,55,0,,16,0,,,,,880,B
20200601,WA,344325,6198,23798,342,320527,5856,1118,0,3501,245,21,,,52,,,B
20200601,WI,274331,3664,20736,172,253595,3492,595,3,2603,613,20,136,586,,,11838,A+
20200601,WV,98095,473,2017,7,96078,466,75,0,,31,0,11,,4,,1313,B
20200601,WY,25147,754,910,7,24237,747,17,1,86,8,1,,,,,667,C
20200531,AK,51695,0,434,0,51261,0,10,0,,14,0,,,2,,368,A
20200531,AL,217553,5352,17903,544,199650,4808,631,13,1844,,18,,589,,355,9355,B
20200531,AR,129515,3018,7253,240,122262,2778,133,0,711,115,9,,,27,123,5275,A
20200531,AS,174,0,0,0,174,0,0,0,,,0,,,,,,C
20200531,AZ,225206,8159,19936,681,205270,7478,906,3,3379,973,45,376,,239,,4761,A+
20200531,CA,1944848,56253,110583,3705,1834265,52548,4213,57,,4331,0,1324,,,,,B
20200531,CO,180627,4886,26098,485,154529,4401,1181,0,4333,414,26,,,,,3919,A
20200531,CT,250046,3111,42201,179,207845,2932,3944,32,12538,481,0,,,,,7127,B
20200531,DC,46483,854,8801,84,37682,770,466,4,,295,0,109,,66,,1116,A+
20200531,DE,60671,1342,9498,76,51173,1266,468,2,,160,0,,,,,5266,A
20200531,FL,1021349,26381,56163,739,965186,25642,2534,4,10453,,78,,,,,,A
20200531,GA,465525,10687,46986,700,418539,9987,2042,39,7946,853,25,,1794,,,,A
20200531,GU,6102,0,173,0,5929,0,5,0,,,0,,,,,144,C
20200531,HI,54620,606,651,2,53969,604,17,0,83,,0,,,,,606,D
20200531,IA,156296,5873,19552,308,136744,5565,534,3,,341,0,116,,70,,11147,A+
20200531,ID,46697,1273,2839,36,43858,1237,82,0,242,29,2,3,96,,,2248,A
20200531,IL,898259,21154,120260,1343,777999,19811,5390,60,,3296,0,941,,550,,,A
20200531,IN,261546,5151,34574,363,226972,4788,2134,9,5285,1050,0,372,1248,143,,21704,A+
20200531,KS,94949,0,9719,0,85230,0,208,0,842,,0,,284,,124,547,A
20200531,KY,213753,5558,9704,240,204049,5318,431,13,2272,480,6,87,940,,,3232,A
20200531,LA,375109,6290,39916,339,335193,5951,2791,6,,678,0,,,84,,28700,B
20200531,MA,592853,10334,96965,664,495888,9670,6846,78,9823,1824,34,436,,,,78108,A
20200531,MD,301881,7935,52778,763,249103,7172,2596,34,8738,1183,119,479,,,,3764,B
20200531,ME,49609,43,2325,43,47284,0,89,0,283,49,11,18,,10,,1552,B
20200531,MI,630760,12930,63568,247,567192,12683,5818,16,,774,0,371,,250,,38099,A+
20200531,MN,283455,6882,26322,141,257133,6741,1050,14,3047,555,36,257,971,,,18695,A
20200531,MO,193561,8131,13147,185,180414,7946,772,1,,718,0,,,83,,,B
20200531,MP,6173,165,22,0,6151,165,2,0,,,0,,,,,15,D
20200531,MS,171837,5905,15501,272,156336,5633,734,11,2272,570,32,113,,108,,9401,A
20200531,MT,39798,514,515,10,39283,504,17,0,67,2,0,,,,,456,C
20200531,NC,416289,12132,28589,916,387700,11216,886,9,,649,0,,,,,14954,A
20200531,ND,72040,1059,2577,23,69463,1036,48,0,167,36,2,,,,,1959,C
20200531,NE,101142,2134,13905,251,87237,1883,170,0,,,0,,,,,,D
20200531,NH,70280,1320,4545,53,65735,1267,242,4,449,107,9,,140,,,2940,B
20200531,NJ,746145,837,160445,837,585700,0,11698,64,17197,2497,76,522,,378,,26560,A+
20200531,NM,194447,6186,7624,131,186823,6055,351,7,1317,189,0,,,,,2835,C
20200531,NV,142560,4028,8593,98,133967,3930,444,5,,336,0,71,,41,,428,A+
20200531,NY,2063825,58444,370770,1110,1693055,57334,23905,57,89590,3436,190,1050,,791,,65934,A
20200531,OH,390908,8961,35513,479,355395,8482,2155,6,6049,779,38,310,1556,213,,,B
20200531,OK,193206,88,6506,88,186700,0,334,0,985,154,3,65,,,,5492,A+
20200531,OR,129201,2406,4243,58,124958,2348,153,0,786,117,8,33,,17,,2152,A+
20200531,PA,455657,7885,72546,515,383111,7370,5555,18,,1352,0,,,296,,48190,A
20200531,PR,64198,58,3776,58,60422,0,136,3,,99,0,9,,1,,,B
20200531,RI,113778,926,14988,76,98790,850,718,7,1701,206,19,46,,29,,1252,A+
20200531,SC,200216,10697,11861,467,188355,10230,494,7,1634,402,0,,,,,6459,A
20200531,SD,44128,1190,4993,33,39135,1157,62,0,432,86,5,,,,,3837,B
20200531,TN,435977,8931,23006,440,412971,8491,364,0,1750,463,18,,,,,15300,B
20200531,TX,951865,23348,64287,1949,887578,21399,1672,46,,1684,0,,,,,42423,B
20200531,UT,213914,3809,9797,264,204117,3545,113,1,775,142,12,,242,,102,6137,B
20200531,VA,315391,9879,44607,996,270784,8883,1375,5,7326,1458,110,371,,196,,5868,A+
20200531,VI,1702,0,69,0,1633,0,6,0,,,0,,,,,61,C
20200531,VT,33970,1303,981,4,32989,1299,55,0,,18,0,,,,,873,B
20200531,WA,338127,2344,23456,181,314671,2163,1118,7,3480,266,25,,,67,,,B
20200531,WI,270667,7377,20564,182,250103,7195,592,4,2583,625,20,133,585,,,11646,A+
20200531,WV,97622,1732,2010,36,95612,1696,75,0,,33,0,14,,8,,1303,B
20200531,WY,24393,310,903,5,23490,305,16,0,85,13,0,,,,,658,C
20200530,AK,51695,2256,434,4,51261,2252,10,0,,14,0,,,2,,368,A
20200530,AL,212201,3318,17359,536,194842,2782,618,13,1826,,26,,583,,349,9355,B
20200530,AR,126497,6729,7013,475,119484,6254,133,8,702,104,35,,,26,123,5166,A
20200530,AS,174,0,0,0,174,0,0,0,,,0,,,,,,C
20200530,AZ,217047,7234,19255,790,197792,6444,903,18,3334,975,53,386,,241,,4657,A+
20200530,CA,1888595,53117,106878,2992,1781717,50125,4156,88,,4215,0,1273,,,,,B
20200530,CO,175741,6782,25613,492,150128,6290,1181,13,4307,421,53,,,,,3859,A
20200530,CT,246935,5542,42022,260,204913,5282,3912,44,12538,533,0,,,,,7127,B
20200530,DC,45629,1771,8717,179,36912,1592,462,2,,317,0,109,,66,,1100,A+
20200530,DE,59329,1796,9422,186,49907,1610,466,3,,174,0,,,,,5205,A
20200530,FL,994968,11729,55424,927,939544,10802,2530,35,10375,,132,,,,,,A
20200530,GA,454838,4567,46286,616,408552,3951,2003,29,7921,850,69,,1790,,,,A
20200530,GU,6102,7,173,1,5929,6,5,0,,,0,,,,,144,C
20200530,HI,54014,1190,649,2,53365,1188,17,0,83,,0,,,,,605,D
20200530,IA,150423,3103,19244,318,131179,2785,531,9,,368,0,118,,69,,11019,A+
20200530,ID,45424,663,2803,34,42621,629,82,0,240,30,2,,96,,,2225,A
20200530,IL,877105,25343,118917,1462,758188,23881,5330,60,,3336,0,925,,661,,,A
20200530,IN,256395,7682,34211,653,222184,7029,2125,15,5285,1149,0,412,1166,161,,,A+
20200530,KS,94949,0,9719,0,85230,0,208,0,842,,0,,284,,124,547,A
20200530,KY,208195,-13079,9464,280,198731,-13359,418,9,2266,499,86,81,940,,,3231,A
20200530,LA,368819,13792,39577,775,329242,13017,2785,19,,674,0,,,84,,28700,B
20200530,MA,582519,10774,96301,789,486218,9985,6768,50,9789,1904,64,453,,,,78108,A
20200530,MD,293946,9428,52015,1027,241931,8401,2562,24,8619,1239,140,492,,,,3649,B
20200530,ME,49566,3860,2282,56,47284,3804,89,4,272,46,2,18,,11,,1505,B
20200530,MI,617830,15846,63321,205,554509,15641,5802,24,,774,0,371,,250,,38099,A+
20200530,MN,276573,8436,26181,168,250392,8268,1036,30,3011,589,75,263,960,,,17864,A
20200530,MO,185430,7580,12962,167,172468,7413,771,33,,679,0,,,85,,,B
20200530,MP,6008,324,22,0,5986,324,2,0,,,0,,,,,15,D
20200530,MS,165932,-376,15229,439,150703,-815,723,13,2240,593,32,145,,92,,9401,A
20200530,MT,39284,755,505,12,38779,743,17,0,67,2,0,,,,,448,C
20200530,NC,404157,12926,27673,1185,376484,11741,877,18,,638,0,,,,,14954,A
20200530,ND,70981,1528,2554,34,68427,1494,48,0,165,34,1,,,,,1943,C
20200530,NE,99008,4205,13654,393,85354,3812,170,6,,,0,,,,,,D
20200530,NH,68960,2098,4492,106,64468,1992,238,6,440,105,2,,120,,,2802,B
20200530,NJ,745308,28897,159608,764,585700,28133,11634,103,17121,2626,161,672,,499,,26301,A+
20200530,NM,188261,4717,7493,129,180768,4588,344,9,1317,193,0,,,,,2728,C
20200530,NV,138532,4116,8495,145,130037,3971,439,4,,371,0,92,,42,,428,A+
20200530,NY,2005381,61251,369660,1376,1635721,59875,23848,68,89400,3619,206,1124,,857,,65609,A
20200530,OH,381947,12057,35034,468,346913,11589,2149,18,6011,806,64,339,1548,219,,,B
20200530,OK,193118,5720,6418,80,186700,5640,334,5,982,154,0,65,,,,5435,A+
20200530,OR,126795,4114,4185,54,122610,4060,153,2,778,131,7,32,,17,,2137,A+
20200530,PA,447772,9463,72031,692,375741,8771,5537,73,,1352,0,,,295,,47133,A
20200530,PR,64140,71,3718,71,60422,0,133,1,,106,0,6,,5,,,B
20200530,RI,112852,1932,14912,104,97940,1828,711,18,1682,219,22,50,,32,,1225,A+
20200530,SC,189519,1262,11394,263,178125,999,487,4,1634,387,0,,,,,6459,A
20200530,SD,42938,2256,4960,94,37978,2162,62,3,427,93,9,,,,,3805,B
20200530,TN,427046,5079,22566,481,404480,4598,364,4,1732,516,22,,,,,15193,B
20200530,TX,928517,35242,62338,1332,866179,33910,1626,0,,1752,0,,,,,40068,B
20200530,UT,210105,4250,9533,269,200572,3981,112,5,763,139,10,,241,,102,5995,B
20200530,VA,305512,7135,43611,1078,261901,6057,1370,12,7216,1471,44,372,,194,,5745,A+
20200530,VI,1702,0,69,0,1633,0,6,0,,,0,,,,,61,C
20200530,VT,32667,782,977,2,31690,780,55,0,,17,0,,,,,865,B
20200530,WA,335783,3298,23275,228,312508,3070,1111,5,3455,319,42,,,88,,,B
20200530,WI,263290,9859,20382,539,242908,9320,588,20,2563,617,64,144,577,,,11338,A+
20200530,WV,95890,2513,1974,23,93916,2490,75,1,,33,0,14,,8,,1290,B
20200530,WY,24083,814,898,7,23185,807,16,1,85,13,1,,,,,658,C
20200529,AK,49439,1469,430,5,49009,1464,10,0,,14,0,,,1,,367,A
20200529,AL,208883,8402,16823,513,192060,7889,605,15,1800,,35,,577,,344,9355,B
20200529,AR,119768,866,6538,0,113230,866,125,5,667,104,27,,,27,119,4583,A
20200529,AS,174,0,0,0,174,0,0,0,,,0,,,,,,C
20200529,AZ,209813,6899,18465,702,191348,6197,885,28,3281,931,58,378,,238,,4551,A+
20200529,CA,1835478,44919,103886,2189,1731592,42730,4068,95,,4414,0,1328,,,,,B
20200529,CO,168959,5836,25121,354,143838,5482,1168,33,4254,464,58,,,,,3838,A
20200529,CT,241393,5868,41762,203,199631,5665,3868,42,12538,577,0,,,,,7127,B
20200529,DC,43858,344,8538,46,35320,298,460,7,,338,0,114,,65,,1089,A+
20200529,DE,57533,732,9236,65,48297,667,463,4,,183,0,,,,,5103,A
20200529,FL,983239,31623,54497,1212,928742,30411,2495,49,10243,,187,,,,,,A
20200529,GA,450271,5625,45670,600,404601,5025,1974,12,7852,889,85,,1780,,,,A
20200529,GU,6095,133,172,0,5923,133,5,0,,,0,,,,,144,C
20200529,HI,52824,985,647,3,52177,982,17,0,83,,0,,,,,604,D
20200529,IA,147320,4387,18926,353,128394,4034,522,18,,376,0,117,,78,,10753,A+
20200529,ID,44761,886,2769,38,41992,848,82,0,238,31,4,,96,,,2195,A
20200529,IL,851762,21796,117455,1622,734307,20174,5270,84,,3599,0,980,,593,,,A
20200529,IN,248713,6426,33558,490,215155,5936,2110,42,5285,1149,0,412,1166,161,,,A+
20200529,KS,94949,10461,9719,382,85230,10079,208,3,842,,20,,284,,124,547,A
20200529,KY,221274,39173,9184,107,212090,39066,409,9,2180,494,38,88,937,,,3181,A
20200529,LA,355027,0,38802,0,316225,0,2766,26,,714,0,,,90,,28700,B
20200529,MA,571745,9422,95512,617,476233,8805,6718,78,9725,1991,107,485,,,,78108,A
20200529,MD,284518,9660,50988,1279,233530,8381,2538,37,8479,1296,87,507,,,,3571,B
20200529,ME,45706,37,2226,37,43480,0,85,1,270,53,6,18,,12,,1458,B
20200529,MI,601984,16524,63116,319,538868,16205,5778,27,,774,0,371,,250,,33168,A+
20200529,MN,268137,10383,26013,454,242124,9929,1006,29,2936,592,56,259,938,,,16930,A
20200529,MO,177850,6783,12795,122,165055,6661,738,31,,650,0,,,85,,,B
20200529,MP,5684,261,22,0,5662,261,2,0,,,0,,,,,13,D
20200529,MS,166308,9811,14790,418,151518,9393,710,17,2208,584,61,121,,77,,9401,A
20200529,MT,38529,1736,493,8,38036,1728,17,0,67,2,1,,,,,448,C
20200529,NC,391231,16039,26488,1076,364743,14963,859,32,,680,0,,,,,14954,A
20200529,ND,69453,1199,2520,39,66933,1160,48,0,164,36,3,,,,,1882,C
20200529,NE,94803,1823,13261,285,81542,1538,164,1,,,0,,,,,,D
20200529,NH,66862,1266,4386,100,62476,1166,232,9,438,110,12,,120,,,2730,B
20200529,NJ,716411,30554,158844,1029,557567,29525,11531,130,16960,2707,182,720,,544,,26084,A+
20200529,NM,183544,4001,7364,112,176180,3889,335,6,1317,196,35,,,,,2684,C
20200529,NV,134416,3226,8350,142,126066,3084,435,10,,371,0,92,,42,,428,A+
20200529,NY,1944130,67341,368284,1551,1575846,65790,23780,58,89194,3781,152,1164,,889,,65289,A
20200529,OH,369890,9878,34566,651,335324,9227,2131,33,5947,833,136,326,1533,222,,,B
20200529,OK,187398,4992,6338,68,181060,4924,329,3,982,160,7,68,,,,5340,A+
20200529,OR,122681,3034,4131,45,118550,2989,151,0,771,155,3,36,,21,,1981,A+
20200529,PA,438309,10463,71339,1297,366970,9166,5464,91,,1445,0,,,313,,46370,A
20200529,PR,64069,161,3647,161,60422,0,132,1,,101,0,12,,5,,,B
20200529,RI,110920,1715,14808,178,96112,1537,693,16,1660,219,21,47,,33,,1206,A+
20200529,SC,188257,6008,11131,343,177126,5665,483,13,1634,399,16,,,,,6459,A
20200529,SD,40682,1656,4866,73,35816,1583,59,5,418,95,12,,,,,3744,B
20200529,TN,421967,5978,22085,406,399882,5572,360,4,1710,507,21,,,,,14965,B
20200529,TX,893275,20057,61006,1230,832269,18827,1626,25,,1701,0,,,,,40068,B
20200529,UT,205855,2348,9264,343,196591,2005,107,1,753,135,19,,237,,102,5813,B
20200529,VA,298377,11096,42533,1132,255844,9964,1358,20,7172,1524,198,373,,193,,5648,A+
20200529,VI,1702,16,69,0,1633,16,6,0,,,0,,,,,61,C
20200529,VT,31885,733,975,1,30910,732,55,0,,14,0,,,,,859,B
20200529,WA,332485,5392,23047,294,309438,5098,1106,11,3413,317,19,,,85,,,B
20200529,WI,253431,13635,19843,766,233588,12869,568,18,2499,658,47,145,567,,,10880,A+
20200529,WV,93377,3062,1951,45,91426,3017,74,0,,33,0,14,,8,,1241,B
20200529,WY,23269,109,891,17,22378,92,15,0,84,13,2,,,,,634,C
20200528,AK,47970,1607,425,13,47545,1594,10,0,,10,0,,,,,366,B
20200528,AL,200481,4687,16310,467,184171,4220,590,9,1765,,46,,566,,338,9355,B
20200528,AR,118902,3306,6538,261,112364,3045,120,0,640,104,13,,,27,118,4583,A
20200528,AS,174,0,0,0,174,0,0,0,,,0,,,,,,C
20200528,AZ,202914,6648,17763,501,185151,6147,857,26,3223,945,51,374,,222,,4452,A+
20200528,CA,1790559,53665,101697,2717,1688862,50948,3973,89,,4529,0,1325,,,,,B
20200528,CO,163123,3703,24767,202,138356,3501,1135,21,4196,464,36,,,,,3783,A
20200528,CT,235525,6656,41559,271,193966,6385,3826,23,12538,648,0,,,,,7127,B
20200528,DC,43514,817,8492,86,35022,731,453,8,,343,0,108,,65,,1082,A+
20200528,DE,56801,1380,9171,75,47630,1305,459,6,,192,0,,,,,5010,A
20200528,FL,951616,18045,53285,651,898331,17394,2446,46,10056,,157,,,,,,A
20200528,GA,444646,3890,45070,649,399576,3241,1962,55,7767,903,101,,1761,,,,A
20200528,GU,5962,277,172,2,5790,275,5,0,,,0,,,,,143,C
20200528,HI,51839,637,644,1,51195,636,17,0,83,,0,,,,,600,D
20200528,IA,142933,3407,18573,213,124360,3194,504,13,,383,0,112,,67,,10359,A+
20200528,ID,43875,858,2731,32,41144,826,82,1,234,30,3,,95,,,2185,A
20200528,IL,829966,25993,115833,1527,714133,24466,5186,103,,3649,0,1009,,576,,,A
20200528,IN,242287,6954,33068,631,209219,6323,2068,38,5285,1131,0,411,1166,178,,,A+
20200528,KS,84488,0,9337,0,75151,0,205,0,822,,0,,275,,122,534,A
20200528,KY,182101,0,9077,0,173024,0,400,0,2142,512,6,82,899,,,3124,A
20200528,LA,355027,7380,38802,305,316225,7075,2740,18,,761,0,,,100,,28700,B
20200528,MA,562323,10179,94895,675,467428,9504,6640,93,9618,2112,126,529,,,,78108,A
20200528,MD,274858,12803,49709,1286,225149,11517,2501,43,8392,1334,111,511,,,,3468,B
20200528,ME,45669,52,2189,52,43480,0,84,3,264,58,4,22,,14,,1402,B
20200528,MI,585460,17390,62797,336,522663,17054,5751,24,,860,0,405,,251,,33168,A+
20200528,MN,257754,9945,25559,571,232195,9374,977,35,2880,606,84,242,924,,,16655,A
20200528,MO,171067,5546,12673,181,158394,5365,707,11,,648,0,,,88,,,B
20200528,MP,5423,223,22,0,5401,223,2,0,,,0,,,,,13,D
20200528,MS,156497,8365,14372,328,142125,8037,693,23,2147,594,41,148,,78,,9401,A
20200528,MT,36793,1150,485,4,36308,1146,17,0,66,1,0,,,,,445,C
20200528,NC,375192,11036,25412,784,349780,10252,827,33,,708,0,,,,,14954,A
20200528,ND,68254,914,2481,42,65773,872,48,4,161,35,0,,,,,1793,C
20200528,NE,92980,2559,12976,357,80004,2202,163,10,,,0,,,,,,D
20200528,NH,65596,1364,4286,55,61310,1309,223,9,426,105,5,,120,,,2691,B
20200528,NJ,685857,25532,157815,1187,528042,24345,11401,62,16778,2797,181,740,,564,,25804,A+
20200528,NM,179543,-1103,7252,122,172291,-1225,329,4,1282,210,0,,,,,2638,C
20200528,NV,131190,2631,8208,95,122982,2536,425,9,,439,0,123,,55,,406,A+
20200528,NY,1876789,65245,366733,1768,1510056,63477,23722,79,89042,4010,176,1219,,931,,64954,A
20200528,OH,360012,10287,33915,476,326097,9811,2098,54,5811,812,111,285,1516,190,,,B
20200528,OK,182406,3768,6270,41,176136,3727,326,4,975,181,34,80,,,,5236,A+
20200528,OR,119647,2655,4086,48,115561,2607,151,3,768,149,9,32,,17,,1981,A+
20200528,PA,427846,8439,70042,625,357804,7814,5373,108,,1476,0,,,321,,44826,A
20200528,PR,63908,20023,3486,89,60422,19934,131,2,,120,0,12,,5,,,B
20200528,RI,109205,1203,14630,132,94575,1071,677,22,1639,222,15,53,,36,,1186,A+
20200528,SC,182249,6566,10788,165,171461,6401,470,4,1618,397,0,,,,,6102,A
20200528,SD,39026,1020,4793,83,34233,937,54,0,406,105,15,,,,,3698,B
20200528,TN,415989,6359,21679,373,394310,5986,356,3,1689,545,42,,,,,14632,B
20200528,TX,873218,17544,59776,1855,813442,15689,1601,39,,1692,0,,,,,38905,B
20200528,UT,203507,2881,8921,215,194586,2666,106,1,734,169,18,,231,,98,5623,B
20200528,VA,287281,10234,41401,1152,245880,9082,1338,57,6974,1502,148,416,,195,,5472,A+
20200528,VI,1686,175,69,0,1617,175,6,0,,,0,,,,,61,C
20200528,VT,31152,153,974,3,30178,150,55,1,,17,0,,,,,855,B
20200528,WA,327093,5232,22753,270,304340,4962,1095,17,3394,325,56,,,94,,,B
20200528,WI,239796,10678,19077,564,220719,10114,550,11,2452,659,41,138,556,,,10384,A+
20200528,WV,90315,1854,1906,39,88409,1815,74,0,,35,0,13,,6,,1211,B
20200528,WY,23160,1658,874,24,22286,1634,15,2,82,15,0,,,,,624,C
20200527,AK,46363,1399,412,1,45951,1398,10,0,,14,0,,,,,364,C
20200527,AL,195794,2035,15843,447,179951,1588,581,6,1719,,48,,560,,334,7951,B
20200527,AR,115596,3823,6277,97,109319,3726,120,1,627,108,10,,,22,116,4424,A
20200527,AS,174,50,0,0,174,50,0,0,,,0,,,,,,C
20200527,AZ,196266,5535,17262,479,179004,5056,831,24,3172,911,50,375,,237,,4361,A+
20200527,CA,1736894,40498,98980,2247,1637914,38251,3884,70,,4544,0,1407,,,,,B
20200527,CO,159420,3409,24565,296,134855,3113,1114,26,4160,484,32,,,,,3741,A
20200527,CT,228869,3507,41288,-15,187581,3522,3803,34,12538,684,0,,,,,7127,B
20200527,DC,42697,642,8406,72,34291,570,445,5,,349,0,113,,76,,1082,A+
20200527,DE,55421,507,9096,30,46325,477,453,9,,196,0,,,,,4909,A
20200527,FL,933571,10347,52634,379,880937,9968,2400,62,9899,,159,,,,,,A
20200527,GA,440756,-74189,44421,691,396335,-74880,1907,36,7666,907,119,,1735,,,,A
20200527,GU,5685,1,170,1,5515,0,5,0,,1,0,,,,,143,C
20200527,HI,51202,831,643,0,50559,831,17,0,83,,-1,,,,,593,D
20200527,IA,139526,4522,18360,657,121166,3865,491,13,,393,0,109,,66,,10016,A+
20200527,ID,43017,1611,2699,73,40318,1538,81,2,231,24,6,,95,,,2100,A
20200527,IL,803973,17179,114306,1111,689667,16068,5083,160,,3826,0,1031,,592,,,A
20200527,IN,235333,4584,32437,359,202896,4225,2030,26,5285,1122,0,400,1166,182,,,A+
20200527,KS,84488,3089,9337,119,75151,2970,205,17,822,,22,,275,,122,534,A
20200527,KY,182101,12245,9077,506,173024,11739,400,9,2136,489,5,78,897,,,3124,A
20200527,LA,347647,6621,38497,443,309150,6178,2722,21,,798,0,,,100,,28700,B
20200527,MA,552144,6663,94220,527,457924,6136,6547,74,9492,2106,104,556,,,,,A
20200527,MD,262055,7568,48423,736,213632,6832,2458,41,8281,1338,102,520,,,,3401,B
20200527,ME,45617,8058,2137,28,43480,8030,81,2,260,59,2,25,,14,,1357,B
20200527,MI,568070,18089,62461,386,505609,17703,5727,24,,882,0,388,,272,,33168,A+
20200527,MN,247809,9527,24988,680,222821,8847,942,34,2796,598,87,260,902,,,16314,A
20200527,MO,165521,5223,12492,201,153029,5022,696,10,,644,0,,,84,,,B
20200527,MP,5200,260,22,0,5178,260,2,0,,,0,,,,,13,D
20200527,MS,148132,313,14044,313,134088,0,670,18,2106,547,36,127,,73,,9401,A
20200527,MT,35643,1809,481,2,35162,1807,17,0,66,2,1,,,,,444,C
20200527,NC,364156,11825,24628,488,339528,11337,794,28,,702,0,,,,,14954,A
20200527,ND,67340,486,2439,17,64901,469,44,4,161,40,5,,,,,1762,C
20200527,NE,90421,2379,12619,264,77802,2115,153,3,,,0,,,,,,D
20200527,NH,64232,1193,4231,34,60001,1159,214,4,421,91,1,,120,,,2550,B
20200527,NJ,660325,24433,156628,864,503697,23569,11339,148,16597,2761,224,768,,583,,25552,A+
20200527,NM,180646,3285,7130,104,173516,3181,325,5,1282,211,18,,,,,2564,C
20200527,NV,128559,5192,8113,116,120446,5076,416,4,,435,0,108,,48,,401,A+
20200527,NY,1811544,37416,364965,1129,1446579,36287,23643,79,88866,4208,180,1261,,988,,64632,A
20200527,OH,349725,10325,33439,433,316286,9892,2044,42,5700,885,121,313,1492,217,,,B
20200527,OK,178638,18697,6229,92,172409,18605,322,4,941,156,0,74,,,,5135,A+
20200527,OR,116992,1454,4038,71,112954,1383,148,0,759,146,7,35,,16,,1795,A+
20200527,PA,419407,10935,69417,780,349990,10155,5265,113,,1493,0,,,351,,43038,A
20200527,PR,43885,73,3397,73,40488,0,129,0,,105,0,8,,4,,,B
20200527,RI,108002,1237,14498,133,93504,1104,655,21,1624,218,11,49,,35,,1175,A+
20200527,SC,175683,2949,10623,207,165060,2742,466,20,1618,398,0,,,,,6102,A
20200527,SD,38006,968,4710,57,33296,911,54,4,391,101,13,,,,,3619,B
20200527,TN,409630,6126,21306,341,388324,5785,353,10,1647,501,38,,,,,13916,B
20200527,TX,855674,34441,57921,1361,797753,33080,1562,26,,1645,0,,,,,37626,B
20200527,UT,200626,2034,8706,86,191920,1948,105,4,716,127,20,,223,,94,5499,B
20200527,VA,277047,9866,40249,907,236798,8959,1281,45,6826,1459,196,390,,203,,5367,A+
20200527,VI,1511,17,69,0,1442,17,6,0,,,0,,,,,61,C
20200527,VT,30999,576,971,4,30028,572,54,0,,21,0,,,,,849,B
20200527,WA,321861,5743,22483,299,299378,5444,1078,8,3338,241,48,,,53,,,B
20200527,WI,229118,10377,18513,646,210605,9731,539,22,2411,748,49,139,550,,,9846,A+
20200527,WV,88461,650,1867,13,86594,637,74,0,,36,0,13,,6,,1191,B
20200527,WY,21502,0,850,0,20652,0,13,0,82,12,0,,,,,607,C
20200526,AK,44964,492,411,2,44553,490,10,0,,12,0,,,,,362,C
20200526,AL,193759,3444,15396,666,178363,2778,575,13,1671,,42,,551,,327,7951,B
20200526,AR,111773,151,6180,151,105593,0,119,2,617,107,12,,,18,114,4332,A
20200526,AS,124,0,0,0,124,0,0,0,,,0,,,,,,C
20200526,AZ,190731,2949,16783,222,173948,2727,807,1,3122,818,45,336,,208,,4297,A+
20200526,CA,1696396,52294,96733,2175,1599663,50119,3814,19,,4404,0,1392,,,,,B
20200526,CO,156011,5703,24269,95,131742,5608,1088,0,4128,507,9,,,,,3702,A
20200526,CT,225362,3636,41303,430,184059,3206,3769,27,12538,694,0,,,,,7127,B
20200526,DC,42055,1252,8334,109,33721,1143,440,0,,353,0,113,,76,,1080,A+
20200526,DE,54914,1018,9066,101,45848,917,444,8,,201,0,,,,,4802,B
20200526,FL,923224,14989,52255,509,870969,14480,2338,7,9740,,59,,,,,,A
20200526,GA,514945,1400,43730,386,471215,1014,1871,41,7547,854,72,,1703,,,,A
20200526,GU,5684,115,169,3,5515,112,5,0,,,0,,,,,139,C
20200526,HI,50371,0,643,0,49728,0,17,0,84,,0,,,,,592,C
20200526,IA,135004,2289,17703,126,117301,2163,478,19,,379,0,115,,65,,9791,A+
20200526,ID,41406,0,2626,0,38780,0,79,0,225,19,0,,94,,,1755,A
20200526,IL,786794,17230,113195,1178,673599,16052,4923,39,,3788,0,1035,,590,,,A
20200526,IN,230749,4498,32078,363,198671,4135,2004,28,5285,1088,0,365,1166,163,,,A+
20200526,KS,81399,0,9218,0,72181,0,188,0,800,,0,,271,,120,493,A+
20200526,KY,169856,0,8571,0,161285,0,391,0,2131,484,0,89,897,,,3102,A
20200526,LA,341026,10128,38054,245,302972,9883,2701,11,,831,0,,,103,,28700,B
20200526,MA,545481,4920,93693,422,451788,4498,6473,57,9388,2108,49,560,,,,,A
20200526,MD,254487,4910,47687,535,206800,4375,2417,38,8179,1315,87,520,,,,3334,B
20200526,ME,37559,35,2109,35,35450,0,79,1,258,60,1,26,,13,,1318,B
20200526,MI,549981,12024,62075,443,487906,11581,5703,25,,953,0,449,,319,,33168,A+
20200526,MN,238282,6942,24308,784,213974,6158,908,18,2709,570,33,258,886,,,15523,A
20200526,MO,160298,2913,12291,124,148007,2789,686,1,,500,0,,,82,,,B
20200526,MP,4940,183,22,0,4918,183,2,0,,,0,,,,,13,D
20200526,MS,147819,3902,13731,273,134088,3629,652,17,2070,561,24,134,,81,,9401,A
20200526,MT,33834,152,479,0,33355,152,17,1,65,2,0,,,,,441,C
20200526,NC,352331,7641,24140,176,328191,7465,766,12,,621,0,,,,,14954,A
20200526,ND,66854,504,2422,-35,64432,539,40,1,156,40,2,,,,,1701,C
20200526,NE,88042,2310,12355,221,75687,2089,150,0,,,0,,,,,,D
20200526,NH,63039,1653,4197,48,58842,1605,210,1,420,91,1,,120,,,2434,B
20200526,NJ,635892,12095,155764,672,480128,11423,11191,47,16373,2723,16373,786,,578,,25384,A+
20200526,NM,177361,3880,7026,83,170335,3797,320,3,1264,216,21,,,,,2522,C
20200526,NV,123367,8636,7997,118,115370,8518,412,2,,390,0,91,,46,,374,A+
20200526,NY,1774128,34679,363836,1072,1410292,33607,23564,76,88686,4265,132,1273,,1002,,64443,A
20200526,OH,339400,9066,33006,529,306394,8537,2002,15,5579,937,68,351,1450,232,,,B
20200526,OK,159941,-1092,6137,47,153804,-1139,318,5,941,174,3,78,,,,4823,A+
20200526,OR,115538,1680,3967,18,111571,1662,148,0,752,149,5,40,,17,,1795,A+
20200526,PA,408472,5358,68637,451,339835,4907,5152,13,,1493,0,,,334,,41868,A
20200526,PR,43812,64,3324,64,40488,0,129,0,,104,0,14,,4,,,B
20200526,RI,106765,1880,14365,154,92400,1726,634,26,1613,226,33,50,,36,,1158,A+
20200526,SC,172734,6714,10416,238,162318,6476,446,6,1618,433,84,,,,,6102,A+
20200526,SD,37038,1755,4653,67,32385,1688,50,0,378,106,8,,,,,3528,C
20200526,TN,403504,7285,20965,358,382539,6927,343,5,1609,582,15,,,,,13344,B
20200526,TX,821233,15579,56560,589,764673,14990,1536,9,,1534,0,,,,,36375,B
20200526,UT,198592,2124,8620,99,189972,2025,101,3,696,134,4,,217,,89,5346,B
20200526,VA,267181,8431,39342,1615,227839,6816,1236,28,6630,1403,109,366,,190,,5227,A+
20200526,VI,1494,82,69,0,1425,82,6,0,,,0,,,,,61,C
20200526,VT,30423,754,967,5,29456,749,54,0,,25,0,,,,,848,B
20200526,WA,316118,6895,22184,275,293934,6620,1070,9,3290,267,3,,,51,,,B
20200526,WI,218741,7791,17867,296,200874,7495,517,3,2362,640,23,135,544,,,9405,A+
20200526,WV,87811,1486,1854,80,85957,1406,74,2,,35,0,9,,7,,1180,B
20200526,WY,21502,1113,850,12,20652,1101,13,1,82,14,3,,,,,607,C
20200525,AK,44472,965,409,1,44063,964,10,0,,10,0,,,,,361,C
20200525,AL,190315,4516,14730,403,175585,4113,562,11,1629,,17,,543,,323,7951,B
20200525,AR,111622,3041,6029,107,105593,2934,117,1,605,92,7,,,17,111,4249,A
20200525,AS,124,0,0,0,124,0,0,0,,,0,,,,,,C
20200525,AZ,187782,4141,16561,222,171221,3919,806,6,3077,833,51,334,,212,,4204,A+
20200525,CA,1644102,61357,94558,1848,1549544,59509,3795,21,,4306,0,1301,,,,,B
20200525,CO,150308,257,24174,210,126134,47,1088,0,4119,560,14,,,,,3666,A
20200525,CT,221726,7590,40873,405,180853,7185,3742,49,12538,706,0,,,,,7127,B
20200525,DC,40803,-11188,8225,259,32578,-11447,440,13,,331,0,106,,70,,1080,A+
20200525,DE,53896,2026,8965,156,44931,1870,436,5,,205,0,,,,,4693,B
20200525,FL,908235,37000,51746,879,856489,36121,2331,15,9681,,43,,,,,,A
20200525,GA,513545,31591,43344,506,470201,31085,1830,6,7475,892,36,,1686,,,,A
20200525,GU,5569,0,166,0,5403,0,5,0,,,0,,,,,138,C
20200525,HI,50371,799,643,0,49728,799,17,0,84,,0,,,,,591,C
20200525,IA,132715,4959,17577,325,115138,4634,459,5,,377,0,118,,66,,9377,A+
20200525,ID,41406,0,2626,0,38780,0,79,0,225,15,0,,94,,,1755,A
20200525,IL,769564,21643,112017,1713,657547,19930,4884,28,,3762,0,1025,,605,,,A
20200525,IN,226251,5450,31715,339,194536,5111,1976,0,5285,1102,0,365,1166,169,,,A+
20200525,KS,81399,4965,9218,260,72181,4705,188,3,800,,13,,271,,120,493,A+
20200525,KY,169856,0,8571,0,161285,0,391,0,2131,484,0,89,897,,,3102,A
20200525,LA,330898,14862,37809,640,293089,14222,2690,0,,847,0,,,102,,28700,B
20200525,MA,540561,8188,93271,596,447290,7592,6416,44,9339,2132,31,576,,,,,A
20200525,MD,249577,9215,47152,839,202425,8376,2379,38,8092,1279,153,517,,,,3329,B
20200525,ME,37524,19,2074,19,35450,0,78,0,257,59,5,27,,13,,1290,B
20200525,MI,537957,9413,61632,175,476325,9238,5678,38,,953,0,449,,319,,33168,A+
20200525,MN,231340,6653,23524,403,207816,6250,890,12,2676,605,88,248,869,,,14816,A
20200525,MO,157385,5766,12167,179,145218,5587,685,4,,729,0,,,93,,,B
20200525,MP,4757,0,22,0,4735,0,2,0,,,0,,,,,13,D
20200525,MS,143917,6015,13458,206,130459,5809,635,10,2046,566,23,152,,94,,9401,A
20200525,MT,33682,301,479,0,33203,301,16,0,65,3,0,,,,,441,C
20200525,NC,344690,8034,23964,742,320726,7292,754,10,,627,0,,,,,14954,A
20200525,ND,66350,862,2457,39,63893,823,39,0,154,41,2,,,,,1551,C
20200525,NE,85732,2527,12134,145,73598,2382,150,3,,,0,,,,,,D
20200525,NH,61386,1847,4149,60,57237,1787,209,1,419,92,0,,120,,,2204,B
20200525,NJ,623797,19990,155092,938,468705,19052,11144,11,,2755,0,719,,540,,25253,A+
20200525,NM,173481,4362,6943,148,166538,4214,317,9,1243,213,104,,,,,2464,C
20200525,NV,114731,4450,7879,109,106852,4341,410,2,,380,0,91,,45,,359,A+
20200525,NY,1739449,39623,362764,1249,1376685,38374,23488,97,88554,4348,230,1366,,1058,,64280,A
20200525,OH,330334,5781,32477,566,297857,5215,1987,18,5511,872,35,323,1443,211,,,B
20200525,OK,161033,53,6090,53,154943,0,313,2,938,,0,78,,,,4714,A+
20200525,OR,113858,1663,3949,22,109909,1641,148,0,747,125,5,35,,23,,1376,A+
20200525,PA,403114,7019,68186,473,334928,6546,5139,15,,1628,0,,,324,,40911,A
20200525,PR,43748,71,3260,71,40488,0,129,2,,112,0,16,,8,,,B
20200525,RI,104885,820,14211,70,90674,750,608,0,1580,240,0,49,,32,,1119,A+
20200525,SC,166020,2073,10178,82,155842,1991,440,5,1534,407,0,,,,,6063,A+
20200525,SD,35283,378,4586,23,30697,355,50,0,370,99,6,,,,,3415,C
20200525,TN,396219,12643,20607,462,375612,12181,338,2,1594,517,11,,,,,13073,B
20200525,TX,805654,42109,55971,623,749683,41486,1527,21,,1511,0,,,,,35292,B
20200525,UT,196468,2035,8521,129,187947,1906,98,1,692,131,4,,215,,88,5218,B
20200525,VA,258750,14665,37727,1483,221023,13182,1208,37,6521,1376,68,349,,182,,5145,A+
20200525,VI,1412,0,69,0,1343,0,6,0,,,0,,,,,61,C
20200525,VT,29669,1079,962,6,28707,1073,54,0,,19,0,,,,,843,B
20200525,WA,309223,2483,21909,257,287314,2226,1061,6,3287,207,31,,,47,,,B
20200525,WI,210950,7491,17571,318,193379,7173,514,4,2339,606,24,126,543,,,9207,A+
20200525,WV,86325,631,1774,15,84551,616,72,0,,36,0,13,,7,,1135,B
20200525,WY,20389,355,838,25,19551,330,12,0,79,10,1,,,,,575,C
20200524,AK,43507,1156,408,0,43099,1156,10,0,,10,0,,,,,358,C
20200524,AL,185799,3123,14327,389,171472,2734,551,5,1612,,23,,537,,320,7951,B
20200524,AR,108581,5534,5922,310,102659,5224,116,3,598,86,8,,,17,111,4148,A
20200524,AS,124,0,0,0,124,0,0,0,,,0,,,,,,C
20200524,AZ,183641,3202,16339,300,167302,2902,800,1,3026,804,42,322,,201,,4132,A+
20200524,CA,1582745,67439,92710,2079,1490035,65360,3774,66,,4300,0,1315,,,,,B
20200524,CO,150051,5099,23964,477,126087,4622,1088,0,4105,538,23,,,,,3640,A
20200524,CT,214136,5769,40468,446,173668,5323,3693,18,12538,701,0,,,,,7127,B
20200524,DC,51991,0,7966,0,44025,0,427,0,,324,0,110,,73,,1075,A+
20200524,DE,51870,1336,8809,119,43061,1217,431,6,,211,0,,,,,4598,B
20200524,FL,871235,14798,50867,740,820368,14058,2316,4,9638,,71,,,,,,A
20200524,GA,481954,28417,42838,706,439116,27711,1824,13,7439,848,28,,1683,,,,A
20200524,GU,5569,210,166,1,5403,209,5,0,,,0,,,,,138,C
20200524,HI,49572,751,643,1,48929,750,17,0,84,,0,,,,,589,C
20200524,IA,127756,3815,17252,359,110504,3456,454,10,,363,0,114,,61,,9318,A+
20200524,ID,41406,797,2626,31,38780,766,79,0,225,23,0,,94,,,1755,A
20200524,IL,747921,25674,110304,2508,637617,23166,4856,66,,3667,0,1007,,632,,,A
20200524,IN,220801,5868,31376,475,189425,5393,1976,33,5285,1112,0,396,1166,173,,,A+
20200524,KS,76434,0,8958,0,67476,0,185,0,787,,0,,269,,120,485,A+
20200524,KY,169856,-1603,8571,145,161285,-1748,391,0,2131,484,55,89,897,,,3102,A
20200524,LA,316036,1589,37169,129,278867,1460,2690,22,,813,0,,,102,,26249,B
20200524,MA,532373,11387,92675,1013,439698,10374,6372,68,9308,2169,48,558,,,,,A
20200524,MD,240362,8035,46313,818,194049,7217,2341,35,7939,1290,114,503,,,,3319,B
20200524,ME,37505,42,2055,42,35450,0,78,1,252,59,9,27,,13,,1263,B
20200524,MI,528544,11695,61457,164,467087,11531,5640,28,,953,0,449,,319,,33168,A+
20200524,MN,224687,6981,23121,356,201566,6625,878,17,2588,553,54,207,841,,,14115,A
20200524,MO,151619,3315,11988,236,139631,3079,681,5,,742,0,,,94,,,B
20200524,MP,4757,439,22,0,4735,439,2,0,,,0,,,,,13,D
20200524,MS,137902,3682,13252,247,124650,3435,625,9,2023,512,27,150,,73,,7681,A
20200524,MT,33381,729,479,0,32902,729,16,0,65,3,0,,,,,441,C
20200524,NC,336656,7074,23222,497,313434,6577,744,7,,587,0,,,,,11637,A
20200524,ND,65488,1340,2418,53,63070,1287,39,0,152,40,2,,,,,1496,C
20200524,NE,83205,3223,11989,327,71216,2896,147,0,,,0,,,,,,D
20200524,NH,59539,0,4089,0,55450,0,208,0,419,93,0,,120,,,2197,B
20200524,NJ,603807,25072,154154,1050,449653,24022,11133,52,,2857,0,760,,639,,25040,A+
20200524,NM,169119,10736,6795,170,162324,10566,308,6,1139,208,0,,,,,2357,C
20200524,NV,110281,3234,7770,74,102511,3160,408,4,,373,0,92,,51,,359,A+
20200524,NY,1699826,47765,361515,1589,1338311,46176,23391,109,88324,4393,241,1406,,1067,,64080,A
20200524,OH,324553,8059,31911,503,292642,7556,1969,13,5476,864,39,317,1438,205,,,B
20200524,OK,160980,77,6037,77,154943,0,311,0,938,174,12,78,,,,4688,A+
20200524,OR,112195,1988,3927,39,108268,1949,148,1,742,117,2,35,,18,,1376,A+
20200524,PA,396095,7643,67713,730,328382,6913,5124,28,,1533,0,,,336,,40627,A
20200524,PR,43677,89,3189,89,40488,0,127,0,,106,0,13,,7,,,B
20200524,RI,104065,841,14141,84,89924,757,608,11,1580,240,23,49,,32,,1119,A+
20200524,SC,163947,5037,10096,201,153851,4836,435,10,1534,461,0,,,,,5743,A+
20200524,SD,34905,1377,4563,95,30342,1282,50,0,364,85,6,,,,,3371,C
20200524,TN,383576,9818,20145,356,363431,9462,336,7,1583,526,10,,,,,12837,B
20200524,TX,763545,839,55348,839,708197,0,1506,0,,1572,0,,,,,33385,B
20200524,UT,194433,3654,8392,132,186041,3522,97,0,688,128,12,,215,,88,5081,B
20200524,VA,244085,11615,36244,495,207841,11120,1171,12,6453,1351,22,354,,192,,5102,A+
20200524,VI,1412,0,69,0,1343,0,6,0,,,0,,,,,61,C
20200524,VT,28590,1166,956,2,27634,1164,54,0,,25,0,,,,,839,B
20200524,WA,306740,2342,21652,160,285088,2182,1055,5,3256,313,26,,,74,,,B
20200524,WI,203459,7287,17253,410,186206,6877,510,3,2315,611,23,128,541,,,8999,A+
20200524,WV,85694,1950,1759,42,83935,1908,72,0,,23,0,8,,4,,1121,B
20200524,WY,20034,0,813,0,19221,0,12,0,78,10,1,,,,,556,C
20200523,AK,42351,905,408,4,41943,901,10,0,,10,0,,,,,358,C
20200523,AL,182676,4908,13938,375,168738,4533,546,9,1589,,28,,538,,319,7951,B
20200523,AR,103047,0,5612,0,97435,0,113,0,590,81,6,,,14,111,4029,A
20200523,AS,124,0,0,0,124,0,0,0,,,0,,,,,,C
20200523,AZ,180439,4436,16039,431,164400,4005,799,24,2984,784,41,309,,193,,4033,A+
20200523,CA,1515306,48533,90631,2187,1424675,46346,3708,78,,4342,0,1312,,,,,B
20200523,CO,144952,2727,23487,296,121465,2431,1088,26,4082,571,45,,,,,3612,A
20200523,CT,208367,6039,40022,382,168345,5657,3675,38,12538,724,0,,,,,7127,B
20200523,DC,51991,8998,7966,73,44025,8925,427,9,,324,0,110,,73,,1075,A+
20200523,DE,50534,1548,8690,161,41844,1387,425,5,,210,0,,,,,4454,B
20200523,FL,856437,20941,50127,676,806310,20265,2312,44,9567,,195,,,,,,A
20200523,GA,453537,26288,42132,914,411405,25374,1811,26,7411,848,98,,1678,,,,A
20200523,GU,5359,80,165,0,5194,80,5,0,,,0,,,,,134,C
20200523,HI,48821,836,642,-5,48179,841,17,0,84,,1,,,,,585,C
20200523,IA,123941,3691,16893,389,107048,3302,444,19,,362,0,111,,70,,9254,A+
20200523,ID,40609,1014,2595,61,38014,953,79,2,225,19,2,,94,,,1735,A
20200523,IL,722247,25114,107796,2352,614451,22762,4790,75,,3753,0,1027,,607,,,A
20200523,IN,214933,6372,30901,492,184032,5880,1943,2,5285,1138,0,403,1166,173,,,A+
20200523,KS,76434,0,8958,0,67476,0,185,0,787,,0,,269,,120,485,A+
20200523,KY,171459,5219,8426,140,163033,5079,391,5,2076,477,35,90,889,,,3069,A
20200523,LA,314447,2639,37040,115,277407,2524,2668,0,,836,0,,,112,,26249,B
20200523,MA,520986,9342,91662,773,429324,8569,6304,76,9260,2237,98,610,,,,,A
20200523,MD,232327,4425,45495,1071,186832,3354,2306,32,7825,1320,191,524,,,,3283,B
20200523,ME,37463,65,2013,65,35450,0,77,2,243,50,3,26,,11,,1232,B
20200523,MI,516849,14492,61293,218,455556,14274,5612,26,,953,0,449,,319,,33168,A+
20200523,MN,217706,8896,22765,391,194941,8505,861,10,2534,568,102,215,832,,,13485,A
20200523,MO,148304,-24642,11752,194,136552,-24836,676,5,,742,0,,,94,,,B
20200523,MP,4318,0,22,0,4296,0,2,0,,,0,,,,,13,D
20200523,MS,134220,-3753,13005,381,121215,-4134,616,20,1996,590,30,154,,93,,7681,A
20200523,MT,32652,795,479,0,32173,795,16,0,65,3,0,,,,,441,C
20200523,NC,329582,26358,22725,1107,306857,25251,737,9,,589,0,,,,,11637,A
20200523,ND,64148,1318,2365,48,61783,1270,39,0,150,39,3,,,,,1451,C
20200523,NE,79982,1563,11662,237,68320,1326,147,4,,,0,,,,,,D
20200523,NH,59539,4439,4089,154,55450,4285,208,9,419,93,26,,120,,,2197,B
20200523,NJ,578735,23421,153104,385,425631,23036,11081,96,,2974,0,806,,611,,24762,A+
20200523,NM,158383,5616,6625,153,151758,5463,302,8,1139,206,0,,,,,2149,C
20200523,NV,107047,7106,7696,295,99351,6811,404,4,,402,0,99,,53,,359,A+
20200523,NY,1652061,51268,359926,1772,1292135,49496,23282,87,88083,4642,240,1502,,1254,,63292,A
20200523,OH,316494,8694,31408,614,285086,8080,1956,84,5437,858,58,333,1429,223,,,B
20200523,OK,160903,7736,5960,111,154943,7625,311,4,926,174,0,78,,,,4645,A+
20200523,OR,110207,2368,3888,24,106319,2344,147,0,740,102,3,41,,15,,1376,A+
20200523,PA,388452,9451,66983,725,321469,8726,5096,112,,1560,0,,,348,,39519,A
20200523,PR,43588,70,3100,70,40488,0,127,1,,106,0,14,,5,,,B
20200523,RI,103224,1425,14057,108,89167,1317,597,18,1557,233,20,51,,34,,1106,A+
20200523,SC,158910,8887,9895,257,149015,8630,425,6,1534,430,0,,,,,5743,A+
20200523,SD,33528,1184,4468,112,29060,1072,50,0,358,90,7,,,,,3336,C
20200523,TN,373758,5588,19789,395,353969,5193,329,14,1573,478,13,,,,,12745,B
20200523,TX,762706,21344,54509,1060,708197,20284,1506,26,,1688,0,,,,,32277,B
20200523,UT,190779,3945,8260,203,182519,3742,97,4,676,165,16,,213,,88,4898,B
20200523,VA,232470,7295,35749,799,196721,6496,1159,23,6431,1384,9,330,,213,,5047,A+
20200523,VI,1412,0,69,0,1343,0,6,0,,,0,,,,,61,C
20200523,VT,27424,1691,954,2,26470,1689,54,0,,21,0,,,,,837,B
20200523,WA,304398,2671,21492,209,282906,2462,1050,6,3230,332,74,,,96,,,B
20200523,WI,196172,7129,16843,503,179329,6626,507,11,2292,611,33,128,542,,,8688,A+
20200523,WV,83744,-1085,1717,101,82027,-1186,72,1,,39,0,11,,9,,1110,B
20200523,WY,20034,610,813,10,19221,600,12,0,77,10,1,,,,,551,C
20200522,AK,41446,1901,404,2,41042,1899,10,0,,15,0,,,,,356,C
20200522,AL,177768,7029,13563,444,164205,6585,537,8,1561,,33,,531,,315,7951,B
20200522,AR,103047,3771,5612,154,97435,3617,113,3,584,86,49,,,14,110,4029,A
20200522,AS,124,0,0,0,124,0,0,0,,,0,,,,,,C
20200522,AZ,176003,4376,15608,293,160395,4083,775,12,2943,796,58,311,,203,,3949,A+
20200522,CA,1466773,45646,88444,2247,1378329,43399,3630,88,,4762,0,1317,,,,,B
20200522,CO,142225,6614,23191,394,119034,6220,1062,61,4037,620,47,,,,,3580,A
20200522,CT,202328,5881,39640,432,162688,5449,3637,55,12538,740,1592,,,,,7127,B
20200522,DC,42993,1237,7893,105,35100,1132,418,6,,342,0,112,,74,,1069,A+
20200522,DE,48986,1444,8529,143,40457,1301,420,3,,221,0,,,,,4296,B
20200522,FL,835496,21567,49451,776,786045,20791,2268,46,9372,,172,,,,,,A
20200522,GA,427249,19518,41218,813,386031,18705,1785,31,7313,889,78,,1658,,,,A
20200522,GU,5279,215,165,0,5114,215,5,0,,,0,,,,,125,C
20200522,HI,47985,836,647,4,47338,832,17,0,83,,1,,,,,579,C
20200522,IA,120250,3685,16504,334,103746,3351,425,19,,362,0,123,,79,,9079,A+
20200522,ID,39595,707,2534,28,37061,679,77,0,223,19,2,,92,,,1720,A
20200522,IL,697133,25113,105444,2758,591689,22355,4715,108,,3928,0,1060,,589,,,A
20200522,IN,208561,5566,30409,473,178152,5093,1941,28,5285,1203,896,416,1166,173,,,A+
20200522,KS,76434,5231,8958,419,67476,4812,185,7,787,,27,,269,,120,485,A+
20200522,KY,166240,7568,8286,119,157954,7449,386,10,2041,475,25,92,886,,,3008,A
20200522,LA,311808,6427,36925,421,274883,6006,2668,39,,867,0,,,104,,26249,B
20200522,MA,511644,10158,90889,805,420755,9353,6228,80,9162,2323,122,628,,,,,A
20200522,MD,227902,7669,44424,893,183478,6776,2274,53,7634,1329,149,506,,,,3243,B
20200522,ME,37398,71,1948,71,35450,0,75,2,240,45,5,21,,12,,1192,B
20200522,MI,502357,19959,61075,465,441282,19494,5586,31,,955,0,470,,348,,28234,A+
20200522,MN,208810,9722,22374,792,186436,8930,851,33,2432,534,52,233,806,,,12696,A
20200522,MO,172946,10854,11558,218,161388,10636,671,10,,711,0,,,93,,,B
20200522,MP,4318,229,22,0,4296,229,2,0,,,0,,,,,13,D
20200522,MS,137973,12003,12624,402,125349,11601,596,16,1966,557,34,159,,85,,7681,A
20200522,MT,31857,1333,479,0,31378,1333,16,0,65,3,0,,,,,441,C
20200522,NC,303224,12579,21618,758,281606,11821,728,12,,568,0,,,,,11637,A
20200522,ND,62830,1551,2317,88,60513,1463,39,1,147,39,3,,,,,1405,C
20200522,NE,78419,2779,11425,303,66994,2476,143,5,,,0,,,,,,D
20200522,NH,55100,2270,3935,67,51165,2203,199,9,393,97,8,,120,,,1767,B
20200522,NJ,555314,11040,152719,1247,402595,9793,10985,142,,3049,0,846,,674,,24491,A+
20200522,NM,152767,5423,6472,155,146295,5268,294,11,1139,205,0,,,,,2041,C
20200522,NV,99941,5559,7401,146,92540,5413,400,3,,404,0,90,,51,,339,A+
20200522,NY,1600793,45738,358154,1696,1242639,44042,23195,112,87843,4844,205,1581,,1254,,63292,A
20200522,OH,307800,8722,30794,627,277006,8095,1872,36,5379,879,84,362,1416,232,,,B
20200522,OK,153167,3572,5849,169,147318,3403,307,3,926,190,9,94,,,,4533,A+
20200522,OR,107839,2615,3864,47,103975,2568,147,2,737,146,5,47,,16,,1376,A+
20200522,PA,379001,10095,66258,866,312743,9229,4984,115,,1580,0,,,368,,37767,A
20200522,PR,43518,117,3030,117,40488,0,126,0,,96,0,12,,6,,,B
20200522,RI,101799,1652,13949,201,87850,1451,579,23,1537,242,31,56,,40,,1084,A+
20200522,SC,150023,11785,9638,463,140385,11322,419,12,1534,429,90,,,,,5743,A+
20200522,SD,32344,1043,4356,106,27988,937,50,2,351,83,9,,,,,3267,C
20200522,TN,368170,7587,19394,433,348776,7154,315,2,1560,570,21,,,,,12566,B
20200522,TX,741362,1181,53449,1181,687913,0,1480,40,,1578,0,,,,,31223,B
20200522,UT,186834,3960,8057,183,178777,3777,93,1,660,163,13,,210,,88,4748,B
20200522,VA,225175,6576,34950,813,190225,5763,1136,37,6422,1459,153,366,,207,,4963,A+
20200522,VI,1412,29,69,0,1343,29,6,0,,,0,,,,,61,C
20200522,VT,25733,32,952,2,24781,30,54,0,,16,0,,,,,834,B
20200522,WA,301727,4568,21283,295,280444,4273,1044,7,3156,332,31,,,85,,,B
20200522,WI,189043,10013,16340,548,172703,9465,496,9,2259,583,41,133,535,,,8362,A+
20200522,WV,84829,1688,1616,23,83213,1665,71,1,,47,0,13,,9,,983,B
20200522,WY,19424,584,803,16,18621,568,12,1,76,10,1,,,,,551,C
20200521,AK,39545,2500,402,0,39143,2500,10,0,,19,0,,,,,356,C
20200521,AL,170739,6289,13119,375,157620,5914,529,12,1528,,35,,526,,311,,B
20200521,AR,99276,3018,5458,455,93818,2563,110,3,535,78,0,,,14,101,3915,A
20200521,AS,124,0,0,0,124,0,0,0,,,0,,,,,,D
20200521,AZ,171627,6192,15315,418,156312,5774,763,16,2885,812,49,299,,197,,3872,A+
20200521,CA,1421127,41007,86197,2140,1334930,38867,3542,106,,4735,0,1310,,,,,B
20200521,CO,135611,3774,22797,315,112814,3459,1001,33,3990,613,35,,,,,3532,A
20200521,CT,196447,5729,39208,191,157239,5538,3582,53,10946,816,0,,,,,6264,B
20200521,DC,41756,1337,7788,237,33968,1100,412,5,,336,0,,,74,,1061,A
20200521,DE,47542,2130,8386,192,39156,1938,417,3,,220,0,,,,,4130,B
20200521,FL,813929,42581,48675,1204,765254,41377,2222,49,9200,,266,,,,,,A
20200521,GA,407731,4791,40405,758,367326,4033,1754,67,7235,959,128,,1642,,,,A
20200521,GU,5064,92,165,0,4899,92,5,0,,,0,,,,,125,C
20200521,HI,47149,845,643,2,46506,843,17,0,82,,0,,,,,578,C
20200521,IA,116565,5817,16170,556,100395,5261,406,18,,376,0,125,,80,,8672,A+
20200521,ID,38888,321,2506,30,36382,291,77,0,221,27,6,,91,,,1688,B
20200521,IL,672020,29307,102686,2268,569334,27039,4607,82,,4107,0,1088,,609,,,A
20200521,IN,202995,7257,29936,662,173059,6595,1913,49,4389,1166,0,409,990,175,,,A+
20200521,KS,71203,0,8539,0,62664,0,178,0,760,,0,,258,,116,473,A+
20200521,KY,158672,4686,8167,98,150505,4588,376,10,2016,474,6,98,879,,,2919,A
20200521,LA,305381,19411,36504,1188,268877,18223,2629,21,,884,0,,,107,,26249,B
20200521,MA,501486,11533,90084,1114,411402,10419,6148,82,9040,2396,143,647,,,,,A
20200521,MD,220233,4903,43531,1208,176702,3695,2221,23,7485,1374,92,526,,,,3099,B
20200521,ME,37327,58,1877,58,35450,0,73,0,235,41,4,21,,12,,1145,B
20200521,MI,482398,16399,60610,459,421788,15940,5555,41,,1054,0,472,,361,,28234,A+
20200521,MN,199088,8280,21582,973,177506,7307,818,32,2380,566,72,229,787,,,12488,A
20200521,MO,162092,108,11340,108,150752,0,661,30,,697,0,,,99,,,B
20200521,MP,4089,272,22,1,4067,271,2,0,,,0,,,,,13,D
20200521,MS,125970,5290,12222,255,113748,5035,580,10,1932,638,31,158,,92,,7681,A
20200521,MT,30524,798,479,1,30045,797,16,0,65,3,0,,,,,440,C
20200521,NC,290645,13042,20860,738,269785,12304,716,14,,578,0,,,,,11637,A
20200521,ND,61279,2079,2229,134,59050,1945,38,1,144,39,2,,,,,1340,C
20200521,NE,75640,3505,11122,276,64518,3229,138,6,,,0,,,,,,D
20200521,NH,52830,1942,3868,147,48962,1795,190,8,385,103,2,,109,,,1388,B
20200521,NJ,544274,12931,151472,1073,392802,11858,10843,96,,3208,0,896,,700,,24236,A+
20200521,NM,147344,5098,6317,125,141027,4973,283,7,1139,206,0,,,,,1985,C
20200521,NV,94382,3211,7255,89,87127,3122,397,4,,410,0,92,,52,,339,A+
20200521,NY,1555055,49219,356458,2088,1198597,47131,23083,107,87638,5187,179,1695,,1345,,62826,A
20200521,OH,299078,9550,30167,731,268911,8819,1836,55,5295,892,97,349,1397,258,,,B
20200521,OK,149595,5224,5680,148,143915,5076,304,5,917,201,12,78,,,,4361,A+
20200521,OR,105224,3075,3817,16,101407,3059,145,1,732,140,9,40,,14,,1406,A+
20200521,PA,368906,19206,65392,1726,303514,17480,4869,245,,1654,0,,,361,,,B
20200521,PR,43401,40535,2913,47,40488,40488,126,1,,114,0,13,,7,,,C
20200521,RI,100147,2108,13748,169,86399,1939,556,18,1506,254,20,56,,41,,1047,A+
20200521,SC,138238,3175,9175,119,129063,3056,407,8,1444,414,0,,,,,5451,A+
20200521,SD,31301,912,4250,73,27051,839,48,2,342,91,9,,,,,3145,C
20200521,TN,360583,6570,18961,429,341622,6141,313,4,1539,601,24,,,,,12191,B
20200521,TX,740181,19253,52268,945,687913,18308,1440,21,,1680,0,,,,,30341,B
20200521,UT,182874,3210,7874,164,175000,3046,92,2,647,169,16,,207,,88,4596,B
20200521,VA,218599,5973,34137,1229,184462,4744,1099,25,6269,1491,210,351,,191,,4778,A+
20200521,VI,1383,0,69,0,1314,0,6,0,,,0,,,,,61,C
20200521,VT,25701,643,950,6,24751,637,54,0,,14,0,,,,,827,B
20200521,WA,297159,4672,20988,204,276171,4468,1037,6,3125,242,3125,,,70,,,B
20200521,WI,179030,9461,15792,523,163238,8938,487,6,2218,524,57,126,526,,,8012,A+
20200521,WV,83141,2500,1593,48,81548,2452,70,1,,46,0,12,,9,,983,B
20200521,WY,18840,0,787,0,18053,0,11,0,75,8,1,,,,,534,C
20200520,AK,37045,665,402,3,36643,662,10,0,,16,0,,,,,352,C
20200520,AL,164450,6884,12744,368,151706,6516,517,13,1493,,40,,524,,309,,B
20200520,AR,96258,2557,5003,80,91255,2477,107,5,535,78,0,,,14,101,3852,A
20200520,AS,124,0,0,0,124,0,0,0,,,0,,,,,,D
20200520,AZ,165435,3864,14897,331,150538,3533,747,43,2836,810,36,298,,208,,3773,A+
20200520,CA,1380120,40804,84057,2262,1296063,38542,3436,102,,4681,0,1345,,,,,B
20200520,CO,131837,504,22482,280,109355,224,968,47,3955,626,56,,,,,3478,A
20200520,CT,190718,5198,39017,587,151701,4611,3529,57,10946,887,0,,,,,6264,B
20200520,DC,40419,1045,7551,117,32868,928,407,7,,336,0,,,74,,1059,A
20200520,DE,45412,1280,8194,157,37218,1123,414,6,,220,0,,,,,3965,B
20200520,FL,771348,55493,47471,527,723877,54966,2173,44,8934,,190,,,,,,A+
20200520,GA,402940,24784,39647,926,363293,23858,1687,23,7107,959,80,,1617,,,,A
20200520,GU,4972,145,165,11,4807,134,5,0,,,0,,,,,125,C
20200520,HI,46304,1281,641,1,45663,1280,17,0,82,,0,,,,,578,C
20200520,IA,110748,3100,15614,265,95134,2835,388,16,,381,0,126,,84,,8362,A+
20200520,ID,38567,498,2476,21,36091,477,77,3,215,28,2,,89,,,1668,B
20200520,IL,642713,21029,100418,2388,542295,18641,4525,146,,3914,0,1005,,554,,,A
20200520,IN,195738,6408,29274,569,166464,5839,1864,40,4389,1288,0,431,990,197,,,A+
20200520,KS,71203,4213,8539,199,62664,4014,178,5,760,,20,,258,,116,473,A+
20200520,KY,153986,0,8069,0,145917,0,366,0,2010,443,30,269,875,,,2826,A
20200520,LA,285970,7897,35316,278,250654,7619,2608,27,,931,0,,,110,,26249,B
20200520,MA,489953,13013,88970,1045,400983,11968,6066,128,8897,2518,131,675,,,,,A
20200520,MD,215330,6672,42323,777,173007,5895,2198,34,7393,1410,194,539,,,,2993,B
20200520,ME,37269,13436,1819,78,35450,13358,73,0,231,43,6,24,,12,,1100,B
20200520,MI,465999,14215,60151,575,405848,13640,5514,44,,1066,0,492,,332,,28234,A+
20200520,MN,190808,6957,20609,767,170199,6190,786,29,2308,550,87,212,773,,,12227,A
20200520,MO,161984,7874,11232,152,150752,7722,631,15,,546,0,,,103,,,B
20200520,MP,3817,0,21,0,3796,0,2,0,,,0,,,,,13,D
20200520,MS,120680,2920,11967,263,108713,2657,570,16,1901,644,61,157,,89,,7681,A
20200520,MT,29726,776,478,7,29248,769,16,0,65,3,0,,,,,440,C
20200520,NC,277603,12595,20122,422,257481,12173,702,11,,554,0,,,,,11637,A
20200520,ND,59200,1469,2095,101,57105,1368,37,0,142,38,7,,,,,1302,C
20200520,NE,72135,2151,10846,221,61289,1930,132,7,,,0,,,,,,D
20200520,NH,50888,1414,3721,69,47167,1345,182,10,383,105,15,,109,,,1275,B
20200520,NJ,531343,11161,150399,1386,380944,9775,10747,161,,3405,0,969,,750,,23945,A+
20200520,NM,142246,4626,6192,96,136054,4530,276,6,1139,204,253,,,,,1882,C
20200520,NV,91171,3616,7166,120,84005,3496,393,3,,437,0,107,,60,,336,A
20200520,NY,1505836,38097,354370,1525,1151466,36572,22976,133,87459,5570,290,1761,,1421,,61886,A
20200520,OH,289528,11926,29436,484,260092,11442,1781,61,5198,902,81,333,1369,248,,,B
20200520,OK,144371,5224,5532,43,138839,5181,299,5,905,209,8,92,,,,4266,A+
20200520,OR,102149,2429,3801,75,98348,2354,144,4,723,152,9,42,,17,,1406,A+
20200520,PA,349700,0,63666,0,286034,0,4624,0,,1818,0,,,377,,,B
20200520,PR,2866,61,2866,61,,0,125,1,,110,0,20,,5,,,C
20200520,RI,98039,1712,13579,187,84460,1525,538,6,1486,257,22,58,,45,,1030,A+
20200520,SC,135063,0,9056,0,126007,0,399,0,1444,,0,,,,,5451,A+
20200520,SD,30389,680,4177,92,26212,588,46,0,333,81,6,,,,,3023,C
20200520,TN,354013,7890,18532,154,335481,7736,309,4,1515,652,17,,,,,11783,B
20200520,TX,720928,20782,51323,1411,669605,19371,1419,50,,1791,0,,,,,30341,B
20200520,UT,179664,2353,7710,192,171954,2161,90,2,631,144,12,,200,,87,4423,B
20200520,VA,212626,9837,32908,763,179718,9074,1074,33,6059,1536,291,370,,202,,4523,A+
20200520,VI,1383,16,69,0,1314,16,6,0,,,0,,,,,61,C
20200520,VT,25058,0,944,0,24114,0,54,0,,15,0,,,,,824,B
20200520,WA,292487,5638,20784,249,271703,5389,1031,29,,168,0,52,,,,,B
20200520,WI,169569,6640,15269,577,154300,6063,481,14,2161,609,51,129,515,,,7728,A+
20200520,WV,80641,2340,1545,36,79096,2304,69,1,,58,0,16,,9,,950,B
20200520,WY,18840,990,787,21,18053,969,11,1,74,9,1,,,,,528,C
20200519,AK,36380,769,399,0,35981,769,10,0,,16,0,,,,,348,B
20200519,AL,157566,443,12376,290,145190,153,504,15,1453,,37,,517,,306,,B
20200519,AR,93701,8462,4923,110,88778,8352,102,2,535,78,5,,,14,101,3739,A
20200519,AS,124,19,0,0,124,19,0,0,,,0,,,,,,C
20200519,AZ,161571,5098,14566,396,147005,4702,704,18,2800,792,43,318,,201,,3693,A+
20200519,CA,1339316,46644,81795,1365,1257521,45279,3334,32,,4363,0,1307,,,,,B
20200519,CO,131333,2838,22202,264,109131,2574,921,43,3899,626,27,,,,,3431,A
20200519,CT,185520,7841,38430,314,147090,7527,3472,23,10946,914,0,,,,,6264,B
20200519,DC,39374,1549,7434,164,31940,1385,400,8,,375,0,,,77,,1040,A
20200519,DE,44132,1674,8037,168,36095,1506,408,9,,236,0,,,,,3760,B
20200519,FL,715855,39443,46944,502,668911,38941,2129,56,8744,,191,,,,,,A+
20200519,GA,378156,13867,38721,640,339435,13227,1664,22,7027,986,111,,1589,,,,A+
20200519,GU,4827,104,154,0,4673,104,5,0,,,0,,,,,126,C
20200519,HI,45023,2978,640,0,44383,2978,17,0,82,,0,,,,,574,B
20200519,IA,107648,4500,15349,394,92299,4106,372,17,,383,0,126,,83,,8130,A+
20200519,ID,38069,1397,2455,36,35614,1361,74,1,213,28,0,,89,,,1649,B
20200519,IL,621684,18443,98030,1545,523654,16898,4379,145,,4002,0,993,,576,,,A
20200519,IN,189330,5418,28705,450,160625,4968,1824,59,4389,1268,0,421,990,206,,,A+
20200519,KS,66990,0,8340,0,58650,0,173,0,740,,0,,250,,115,465,A
20200519,KY,153986,24301,8069,381,145917,23920,366,32,1980,447,84,277,866,,,2826,A+
20200519,LA,278073,8325,35038,329,243035,7996,2581,18,,1004,0,,,112,,26249,B
20200519,MA,476940,7741,87925,873,389015,6868,5938,76,8766,2472,145,672,,,,,A+
20200519,MD,208658,7152,41546,1784,167112,5368,2164,42,7199,1421,113,537,,,,2868,B
20200519,ME,23833,28,1741,28,22092,0,73,2,225,44,2,19,,11,,1088,B
20200519,MI,451784,16857,59576,764,392208,16093,5470,43,,1079,0,486,,351,,28234,A+
20200519,MN,183851,6377,19842,855,164009,5522,757,17,2221,545,93,229,750,,,11540,A+
20200519,MO,154110,2772,11080,135,143030,2637,616,11,,721,0,,,103,,,B
20200519,MP,3817,397,21,0,3796,397,2,0,,,0,,,,,13,D
20200519,MS,117760,1993,11704,272,106056,1721,554,26,1840,611,35,153,,87,,7681,A
20200519,MT,28950,783,471,1,28479,782,16,0,65,5,1,,,,,437,B
20200519,NC,265008,9253,19700,677,245308,8576,691,30,,585,0,,,,,11637,A
20200519,ND,57731,1170,1994,63,55737,1107,37,0,135,32,2,,,,,1269,C
20200519,NE,69984,2483,10625,277,59359,2206,125,2,,,0,,,,,,C
20200519,NH,49474,4596,3652,56,45822,4540,172,0,368,109,9,,109,,,1269,B
20200519,NJ,520182,14613,149013,974,371169,13639,10586,151,,3481,0,977,,789,,23657,A+
20200519,NM,137620,4367,6096,158,131524,4209,270,5,886,213,0,,,,,1796,C
20200519,NV,87555,5723,7046,140,80509,5583,390,7,,405,0,106,,54,,334,B
20200519,NY,1467739,28182,352845,1474,1114894,26708,22843,114,87169,5818,268,1836,,1481,,61886,A
20200519,OH,277602,5753,28952,498,248650,5255,1720,63,5117,913,119,365,1357,234,,,B
20200519,OK,139147,15587,5489,91,133658,15496,294,6,897,167,12,77,,,,4135,A+
20200519,OR,99720,2405,3726,39,95994,2366,140,2,714,137,6,43,,13,,1406,A+
20200519,PA,349700,9091,63666,610,286034,8481,4624,119,,1861,0,,,380,,,B
20200519,PR,2805,95,2805,95,,0,124,0,,121,0,20,,8,,,C
20200519,RI,96327,2093,13392,215,82935,1878,532,26,1464,247,26,59,,44,,1023,A+
20200519,SC,135063,3504,9056,114,126007,3390,399,8,1444,,23,,,,,5451,A
20200519,SD,29709,664,4085,58,25624,606,46,2,327,75,11,,,,,2914,B
20200519,TN,346123,8695,18378,367,327745,8328,305,4,1498,615,9,,,,,10969,A
20200519,TX,700146,20301,49912,1219,650234,19082,1369,22,,1732,0,,,,,29359,A
20200519,UT,177311,3289,7518,134,169793,3155,88,8,619,96,24,,197,,84,4275,B
20200519,VA,202789,6563,32145,1005,170644,5558,1041,27,5768,1497,159,377,,199,,4271,A+
20200519,VI,1367,20,69,0,1298,20,6,0,,,0,,,,,61,C
20200519,VT,25058,567,944,0,24114,567,54,0,,24,0,,,,,820,B
20200519,WA,286849,7096,20535,249,266314,6847,1002,1,,168,0,52,,,,,A
20200519,WI,162929,3985,14692,250,148237,3735,467,8,2110,609,42,129,503,,,7371,A+
20200519,WV,78301,2266,1509,18,76792,2248,68,1,,54,0,18,,9,,922,B
20200519,WY,17850,765,766,12,17084,753,10,2,73,8,0,,,,,504,B
20200518,AK,35611,960,399,3,35212,957,10,0,,9,0,,,,,345,B
20200518,AL,157123,773,12086,315,145037,458,489,1,1416,,24,,512,,302,,B
20200518,AR,85239,54,4813,54,80426,0,100,2,530,77,10,,,12,101,3645,A
20200518,AS,105,0,0,0,105,0,0,0,,,0,,,,,,C
20200518,AZ,156473,4712,14170,233,142303,4479,686,6,2757,820,54,329,,200,,3570,A+
20200518,CA,1292672,57429,80430,1591,1212242,55838,3302,41,,4391,0,1325,,,,,B
20200518,CO,128495,2947,21938,305,106557,2642,878,0,3872,650,6,,,,,3346,A
20200518,CT,177679,7072,38116,697,139563,6375,3449,41,10946,920,0,,,,,6264,B
20200518,DC,37825,1299,7270,147,30555,1152,392,9,,374,0,,,70,,1028,A
20200518,DE,42458,1593,7869,199,34589,1394,399,7,,240,0,,,,,3545,B
20200518,FL,676412,24620,46442,854,629970,23766,2073,24,8553,,75,,,,,,A+
20200518,GA,364289,13114,38081,380,326208,12734,1642,36,6916,1025,126,,1565,,,,A+
20200518,GU,4723,119,154,0,4569,119,5,0,,,0,,,,,126,C
20200518,HI,42045,371,640,1,41405,370,17,0,82,,0,,,,,573,B
20200518,IA,103148,2907,14955,304,88193,2603,355,4,,382,0,121,,85,,7324,A+
20200518,ID,36672,0,2419,0,34253,0,73,0,213,30,0,,89,,,1612,B
20200518,IL,603241,21297,96485,2294,506756,19003,4234,57,,4120,0,1096,,636,,,A
20200518,IN,183912,6669,28255,477,155657,6192,1765,14,4389,1244,0,426,990,212,,,A+
20200518,KS,66990,5398,8340,454,58650,4944,173,1,740,,16,,250,,115,465,A
20200518,KY,129685,0,7688,0,121997,0,334,0,1896,381,0,218,797,,,2768,A+
20200518,LA,269748,4578,34709,277,235039,4301,2563,72,,1031,0,,,118,,26249,B
20200518,MA,469199,8373,87052,1042,382147,7331,5862,65,8621,2533,82,674,,,,,A+
20200518,MD,201506,6580,39762,958,161744,5622,2122,32,7086,1447,93,555,,,,2817,B
20200518,ME,23805,26,1713,26,22092,0,71,1,223,42,7,16,,10,,1053,B
20200518,MI,434927,13101,58812,534,376115,12567,5427,31,,1075,0,473,,418,,28234,A+
20200518,MN,177474,6389,18987,971,158487,5418,740,9,2128,488,38,229,731,,,10764,A+
20200518,MO,151338,5083,10945,156,140393,4927,605,11,,570,0,,,91,,,B
20200518,MP,3420,81,21,0,3399,81,2,0,,,0,,,,,12,D
20200518,MS,115767,2641,11432,136,104335,2505,528,7,1805,559,32,141,,75,,7681,A
20200518,MT,28167,1282,470,2,27697,1280,16,0,64,4,1,,,,,434,B
20200518,NC,255755,6811,19023,511,236732,6300,661,2,,511,0,,,,,11637,A
20200518,ND,56561,1340,1931,31,54630,1309,37,2,133,32,3,,,,,1219,C
20200518,NE,67501,1861,10348,128,57153,1733,123,0,,,0,,,,,,C
20200518,NH,44878,126,3596,40,41282,86,172,1,359,114,12,,109,,,1268,B
20200518,NJ,505569,18004,148039,1705,357530,16299,10435,79,,3509,0,1053,,819,,23496,A+
20200518,NM,133253,4669,5938,81,127315,4588,265,6,886,211,0,,,,,1755,C
20200518,NV,81832,1195,6906,49,74926,1146,383,8,,423,0,105,,65,,355,B
20200518,NY,1439557,26161,351371,1250,1088186,24911,22729,110,86901,5840,326,1908,,1538,,61681,A
20200518,OH,271849,7387,28454,531,243395,6856,1657,32,4998,912,77,367,1328,247,,,B
20200518,OK,123560,88,5398,88,118162,0,288,0,885,76,5,45,,,,4008,A+
20200518,OR,97315,2959,3687,64,93628,2895,138,1,708,137,5,43,,13,,1406,A+
20200518,PA,340609,7705,63056,822,277553,6883,4505,87,,1885,0,,,397,,,C
20200518,PR,2710,64,2710,64,,0,124,1,,147,0,17,,4,,,C
20200518,RI,94234,1426,13177,137,81057,1289,506,7,1438,236,20,62,,46,,1012,A+
20200518,SC,131559,11073,8942,126,122617,10947,391,11,1421,,0,,,,,5076,A
20200518,SD,29045,486,4027,40,25018,446,44,0,316,77,4,,,,,2784,B
20200518,TN,337428,12148,18011,623,319417,11525,301,3,1489,638,7,,,,,9886,A
20200518,TX,679845,29490,48693,909,631152,28581,1347,11,,1551,0,,,,,28371,A
20200518,UT,174022,3270,7384,146,166638,3124,80,0,595,179,9,,197,,84,4183,B
20200518,VA,196226,5865,31140,752,165086,5113,1014,5,5609,1502,92,361,,194,,4107,A+
20200518,VI,1347,0,69,0,1278,0,6,0,,,0,,,,,61,C
20200518,VT,24491,577,944,4,23547,573,54,0,,22,0,,,,,815,B
20200518,WA,279753,6982,20286,295,259467,6687,1001,1,,168,0,52,,,,,A
20200518,WI,158944,5013,14442,185,144502,4828,459,6,2068,574,30,128,496,,,6786,A+
20200518,WV,76035,545,1491,1,74544,544,67,0,,48,0,11,,7,,919,B
20200518,WY,17085,0,754,0,16331,0,8,0,73,8,3,,,,,498,B
20200517,AK,34651,1370,396,4,34255,1366,10,0,,13,0,,,,,344,B
20200517,AL,156350,2856,11771,248,144579,2608,488,3,1392,,5,,504,,296,,B
20200517,AR,85185,3541,4759,181,80426,3360,98,0,520,65,0,,,9,101,3590,A
20200517,AS,105,0,0,0,105,0,0,0,,,0,,,,,,C
20200517,AZ,151761,4973,13937,306,137824,4667,680,1,2703,796,30,337,,201,,3450,A+
20200517,CA,1235243,56117,78839,2046,1156404,54071,3261,57,,4291,0,1293,,,,,B
20200517,CO,125548,3708,21633,401,103915,3307,878,0,3866,650,24,,,,,3346,A
20200517,CT,170607,5852,37419,716,133188,5136,3408,69,10946,937,0,,,,,6264,B
20200517,DC,36526,994,7123,81,29403,913,383,8,,369,0,,,74,,1023,A
20200517,DE,40865,1107,7670,123,33195,984,392,9,,229,0,,,,,3478,B
20200517,FL,651792,21745,45588,777,606204,20968,2049,9,8478,,85,,,,,,A+
20200517,GA,351175,30106,37701,554,313474,29552,1606,14,6790,1010,55,,1557,,,,A+
20200517,GU,4604,85,154,0,4450,85,5,0,,,0,,,,,126,C
20200517,HI,41674,791,639,1,41035,790,17,0,82,,1,,,,,572,B
20200517,IA,100241,3941,14651,323,85590,3618,351,5,,376,0,124,,85,,7154,A+
20200517,ID,36672,984,2419,30,34253,954,73,0,213,26,0,,89,,,1612,B
20200517,IL,581944,20295,94191,1734,487753,18561,4177,48,,4190,0,1144,,735,,,A
20200517,IN,177243,5885,27778,498,149465,5387,1751,10,4389,1246,0,441,990,205,,,A+
20200517,KS,61592,0,7886,0,53706,0,172,0,724,,0,,246,,112,443,A
20200517,KY,129685,1951,7688,244,121997,1707,334,2,1896,381,0,218,797,,,2768,A+
20200517,LA,265170,5428,34432,315,230738,5113,2491,12,,1019,0,,,111,,22608,B
20200517,MA,460826,12737,86010,1077,374816,11660,5797,92,8539,2597,83,702,,,,,A+
20200517,MD,194926,4751,38804,836,156122,3915,2090,50,6993,1460,238,562,,,,2816,B
20200517,ME,23779,39,1687,39,22092,0,70,0,216,37,2,16,,11,,1028,B
20200517,MI,421826,10647,58278,255,363548,10392,5396,39,,1114,0,488,,434,,28234,A+
20200517,MN,171085,5981,18016,311,153069,5670,731,22,2090,487,51,221,716,,,10175,A+
20200517,MO,146255,6915,10789,114,135466,6801,594,5,,775,0,,,116,,,B
20200517,MP,3339,0,21,0,3318,0,2,0,,,0,,,,,12,D
20200517,MS,113126,4650,11296,173,101830,4477,521,11,1773,608,25,158,,81,,6268,A
20200517,MT,26885,794,468,0,26417,794,16,0,63,3,0,,,,,431,B
20200517,NC,248944,10358,18512,530,230432,9828,659,7,,493,0,,,,,9115,A
20200517,ND,55221,1734,1900,52,53321,1682,35,0,130,30,0,,,,,1178,C
20200517,NE,65640,5662,10220,448,55420,5214,123,4,,,0,,,,,,C
20200517,NH,44752,2076,3556,92,41196,1984,171,12,347,115,12,,109,,,1258,B
20200517,NJ,487565,12341,146334,1245,341231,11096,10356,107,,3411,0,1030,,819,,23299,A+
20200517,NM,128584,4126,5857,195,122727,3931,259,6,886,208,0,,,,,1739,C
20200517,NV,80637,6973,6857,195,73780,6778,375,6,,423,0,105,,65,,272,B
20200517,NY,1413396,34679,350121,1889,1063275,32790,22619,141,86575,5897,368,1981,,1601,,61381,A
20200517,OH,264462,17760,27923,449,236539,17311,1625,15,4921,914,51,343,1305,230,,,B
20200517,OK,123472,73,5310,73,118162,0,288,0,880,180,2,73,,,,3983,A+
20200517,OR,94356,2157,3623,11,90733,2146,137,0,703,156,4,37,,16,,1406,A+
20200517,PA,332904,5068,62234,623,270670,4445,4418,15,,1821,0,,,422,,,C
20200517,PR,2646,57,2646,57,,0,123,1,,150,0,24,,5,,,C
20200517,RI,92808,1662,13040,125,79768,1537,499,10,1418,260,15,64,,45,,972,A+
20200517,SC,120486,10870,8816,409,111670,10461,380,0,1421,,0,,,,,5076,A
20200517,SD,28559,383,3987,28,24572,355,44,0,312,77,8,,,,,2724,B
20200517,TN,325280,5079,17388,100,307892,4979,298,3,1482,513,8,,,,,9652,A
20200517,TX,650355,11616,47784,785,602571,10831,1336,31,,1512,0,,,,,27570,A
20200517,UT,170752,3978,7238,170,163514,3808,80,2,586,181,8,,196,,84,4075,B
20200517,VA,190361,4793,30388,705,159973,4088,1009,7,5517,1524,103,379,,195,,3993,A+
20200517,VI,1347,84,69,0,1278,84,6,0,,,0,,,,,61,C
20200517,VT,23914,777,940,0,22974,777,54,1,,14,0,,,,,810,B
20200517,WA,272771,1970,19991,153,252780,1817,1000,8,,168,0,52,,,,,A
20200517,WI,153931,5847,14257,379,139674,5468,453,0,2038,543,20,129,494,,,6542,A+
20200517,WV,75490,2097,1490,33,74000,2064,67,3,,48,0,11,,7,,919,B
20200517,WY,17085,691,754,38,16331,653,8,1,70,8,1,,,,,498,B
20200516,AK,33281,863,392,4,32889,859,10,0,,10,0,,,,,344,B
20200516,AL,153494,7431,11523,307,141971,7124,485,9,1387,,10,,501,,295,,B
20200516,AR,81644,115,4578,115,77066,0,98,0,520,65,0,,,10,101,3472,A
20200516,AS,105,0,0,0,105,0,0,0,,,0,,,,,,C
20200516,AZ,146788,4787,13631,462,133157,4325,679,28,2673,791,37,344,,210,,3357,A+
20200516,CA,1179126,45220,76793,1857,1102333,43363,3204,96,,4424,0,1313,,,,,B
20200516,CO,121840,3810,21232,394,100608,3416,878,-213,3842,671,53,,,,,3312,A
20200516,CT,164755,8847,36703,618,128052,8229,3339,54,10946,994,0,,,,,6264,B
20200516,DC,35532,1193,7042,171,28490,1022,375,7,,382,0,,,79,,998,A
20200516,DE,39758,1480,7547,174,32211,1306,383,10,,250,0,,,,,3367,B
20200516,FL,630047,21210,44811,1601,585236,19609,2040,49,8393,,400,,,,,,A+
20200516,GA,321069,19195,37147,466,283922,18729,1592,35,6735,1005,297,,1554,,,,A+
20200516,GU,4519,4,154,0,4365,4,5,0,,,0,,,,,126,C
20200516,HI,40883,2107,638,1,40245,2106,17,0,81,,0,,,,,565,B
20200516,IA,96300,2734,14328,279,81972,2455,346,10,,387,0,128,,83,,6927,A+
20200516,ID,35688,943,2389,38,33299,905,73,1,213,19,1,,89,,,1588,B
20200516,IL,561649,23047,92457,2088,469192,20959,4129,71,,4306,0,1135,,653,,,A
20200516,IN,171358,5910,27280,625,144078,5285,1741,50,4389,1274,0,426,990,199,,,A+
20200516,KS,61592,0,7886,0,53706,0,172,0,724,,0,,246,,112,443,A
20200516,KY,127734,6456,7444,219,120290,6237,332,4,1896,381,9,218,797,,,2739,A+
20200516,LA,259742,6553,34117,280,225625,6273,2479,31,,1028,0,,,123,,22608,B
20200516,MA,448089,12410,84933,1512,363156,10898,5705,113,8456,2692,142,747,,,,,A+
20200516,MD,190175,7349,37968,982,152207,6367,2040,49,6755,1500,76,598,,,,2806,B
20200516,ME,23740,45,1648,45,22092,0,70,1,214,37,3,19,,10,,1012,B
20200516,MI,411179,11665,58023,336,353156,11329,5357,32,,1256,0,532,,440,,28234,A+
20200516,MN,165104,7968,17705,342,147399,7626,709,17,2039,493,54,225,700,,,9571,A+
20200516,MO,139340,4882,10675,219,128665,4663,589,13,,775,0,,,116,,,B
20200516,MP,3339,14,21,2,3318,12,2,0,,,0,,,,,12,D
20200516,MS,108476,1653,11123,322,97353,1331,510,17,1748,641,36,170,,81,,6268,A
20200516,MT,26091,673,468,2,25623,671,16,0,63,3,0,,,,,431,B
20200516,NC,238586,7039,17982,853,220604,6186,652,11,,481,0,,,,,9115,A
20200516,ND,53487,1772,1848,87,51639,1685,35,0,130,33,0,,,,,1111,C
20200516,NE,59978,2763,9772,356,50206,2407,119,6,,,0,,,,,,C
20200516,NH,42676,64,3464,0,39212,64,159,0,335,110,0,,109,,,1254,B
20200516,NJ,475224,12252,145089,1184,330135,11068,10249,111,,3564,0,1061,,846,,22939,A+
20200516,NM,124458,4857,5662,159,118796,4698,253,11,886,223,0,,,,,1671,C
20200516,NV,73664,1518,6662,48,67002,1470,369,1,,423,0,105,,65,,272,B
20200516,NY,1378717,40669,348232,2419,1030485,38250,22478,174,86207,6220,425,2077,,1674,,60796,A
20200516,OH,246702,520,27474,520,219228,0,1610,29,4870,866,79,366,1277,251,,,B
20200516,OK,123399,5207,5237,151,118162,5056,288,3,878,180,15,73,,,,3945,A+
20200516,OR,92199,2693,3612,71,88587,2622,137,0,699,153,8,48,,16,,1406,A+
20200516,PA,327836,8004,61611,989,266225,7015,4403,61,,1873,0,,,429,,,C
20200516,PR,2589,47,2589,47,,0,122,0,,144,0,15,,5,,,B
20200516,RI,91146,2016,12915,252,78231,1764,489,10,1403,273,31,66,,44,,947,A+
20200516,SC,109616,0,8407,0,101209,0,380,0,1421,,0,,,,,5076,A
20200516,SD,28176,762,3959,72,24217,690,44,0,304,75,8,,,,,2673,B
20200516,TN,320201,10445,17288,318,302913,10127,295,5,1474,515,20,,,,,9529,A
20200516,TX,638739,29109,46999,1801,591740,27308,1305,33,,1791,0,,,,,26601,A
20200516,UT,166774,3556,7068,155,159706,3401,78,1,578,168,12,,194,,84,3896,B
20200516,VA,185568,7554,29683,1011,155885,6543,1002,25,5414,1505,98,381,,189,,3909,A+
20200516,VI,1263,0,69,0,1194,0,6,0,,,0,,,,,61,C
20200516,VT,23137,968,940,8,22197,960,53,0,,20,0,,,,,804,B
20200516,WA,270801,2829,19838,188,250963,2641,992,9,,331,0,90,,,,,A
20200516,WI,148084,6083,13878,534,134206,5549,453,8,2018,546,41,127,488,,,6542,A+
20200516,WV,73393,2457,1457,16,71936,2441,64,2,,55,0,13,,6,,889,B
20200516,WY,16394,372,716,1,15678,371,7,0,69,8,1,,,,,496,B
20200515,AK,32418,656,388,1,32030,655,10,0,,8,0,,,,,343,B
20200515,AL,146063,4078,11216,248,134847,3830,476,9,1377,,27,,497,,293,,B
20200515,AR,81529,5711,4463,227,77066,5484,98,1,520,65,11,,,9,101,3390,A
20200515,AS,105,0,0,0,105,0,0,0,,,0,,,,,,C
20200515,AZ,142001,7663,13169,495,128832,7168,651,27,2636,808,41,313,,222,,3145,A+
20200515,CA,1133906,29255,74936,1772,1058970,27483,3108,76,,4519,0,1324,,,,,B
20200515,CO,118030,3511,20838,363,97192,3148,1091,29,3789,685,54,,,,,3217,A
20200515,CT,155908,6346,36085,621,119823,5725,3285,66,10946,1033,0,,,,,6264,B
20200515,DC,34339,1340,6871,135,27468,1205,368,10,,393,0,,,90,,975,A
20200515,DE,38278,1421,7373,150,30905,1271,373,11,,269,0,,,,,3210,B
20200515,FL,608837,0,43210,0,565627,0,1991,43,7993,,0,,,,,,A+
20200515,GA,301874,15993,36681,823,265193,15170,1557,30,6438,,93,,1534,,,,A+
20200515,GU,4515,136,154,1,4361,135,5,0,,,0,,,,,124,C
20200515,HI,38776,-105,637,-1,38139,-104,17,0,81,,0,,,,,564,B
20200515,IA,93566,4272,14049,374,79517,3898,336,18,,387,0,130,,87,,6561,A+
20200515,ID,34745,991,2351,27,32394,964,72,3,212,26,0,,89,,,1573,B
20200515,IL,538602,26565,90369,2432,448233,24133,4058,130,,4367,0,1129,,675,,,A
20200515,IN,165448,5209,26655,602,138793,4607,1691,45,4389,1294,0,492,990,213,,,A+
20200515,KS,61592,3964,7886,418,53706,3546,172,8,724,,20,,246,,112,443,A
20200515,KY,121278,3883,7225,145,114053,3738,328,2,1887,385,52,220,794,,,2712,A+
20200515,LA,253189,5601,33837,348,219352,5253,2448,31,,1091,0,,,132,,22608,B
20200515,MA,435679,11318,83421,1239,352258,10079,5592,110,8314,2767,107,749,,,,,A+
20200515,MD,182826,4372,36986,1083,145840,3289,1991,56,6679,1496,126,598,,,,2685,B
20200515,ME,23695,38,1603,38,22092,0,69,0,211,35,4,16,,8,,993,B
20200515,MI,399514,15821,57687,651,341827,15170,5325,47,,1256,0,532,,440,,22686,A+
20200515,MN,157136,9128,17363,798,139773,8330,692,29,1985,498,70,200,679,,,8820,A+
20200515,MO,134458,7348,10456,139,124002,7209,576,14,,812,0,,,120,,,B
20200515,MP,3325,0,19,0,3306,0,2,0,,,0,,,,,12,D
20200515,MS,106823,1497,10801,318,96022,1179,493,13,1712,573,45,172,,81,,6268,A
20200515,MT,25418,869,466,4,24952,865,16,0,63,3,0,,,,,431,B
20200515,NC,231547,12279,17129,622,214418,11657,641,26,,492,0,,,,,9115,A
20200515,ND,51715,1469,1761,114,49954,1355,35,4,130,35,1,,,,,1071,C
20200515,NE,57215,3874,9416,341,47799,3533,113,6,,,0,,,,,,C
20200515,NH,42612,3437,3464,165,39148,3272,159,9,335,115,9,,109,,,1247,B
20200515,NJ,462972,11276,143905,1201,319067,10075,10138,192,,3823,0,1127,,865,,15642,A+
20200515,NM,119601,4590,5503,139,114098,4451,242,11,886,209,0,,,,,1576,C
20200515,NV,72146,2662,6614,115,65532,2547,368,10,,425,0,115,,73,,272,B
20200515,NY,1338048,39291,345813,2762,992235,36529,22304,134,85782,6394,328,2156,,1774,,60302,A
20200515,OH,246182,12830,26954,597,219228,12233,1581,47,4791,944,73,370,1277,260,,,B
20200515,OK,118192,6009,5086,124,113106,5885,285,1,863,215,5,98,,,,3801,A+
20200515,OR,89506,5456,3541,62,85965,5394,137,0,691,161,6,46,,19,,1406,A+
20200515,PA,319832,8637,60622,986,259210,7651,4342,124,,1934,0,,,431,,,C
20200515,PR,2542,115,2542,115,,0,122,5,,147,0,18,,3,,,B
20200515,RI,89130,1932,12663,232,76467,1700,479,11,1372,272,21,63,,41,,919,A+
20200515,SC,109616,7081,8407,218,101209,6863,380,9,1421,,83,,,,,5076,A
20200515,SD,27414,941,3887,95,23527,846,44,1,296,80,6,,,,,2574,B
20200515,TN,309756,7439,16970,271,292786,7168,290,3,1454,535,19,,,,,9280,A
20200515,TX,609630,22317,45198,1347,564432,20970,1272,56,,1716,0,,,,,25454,A
20200515,UT,163218,3099,6913,164,156305,2935,77,2,566,161,8,,190,,83,3719,B
20200515,VA,178014,11184,28672,859,149342,10325,977,22,5316,1511,105,362,,195,,3805,A+
20200515,VI,1263,30,69,0,1194,30,6,0,,,0,,,,,61,C
20200515,VT,22169,741,932,1,21237,740,53,0,,17,0,,,,,796,B
20200515,WA,267972,5404,19650,226,248322,5178,983,8,,374,0,114,,,,,A
20200515,WI,142001,6534,13344,475,128657,6059,445,11,1977,548,38,113,485,,,6250,A+
20200515,WV,70936,2223,1441,14,69495,2209,62,2,,57,0,15,,8,,870,B
20200515,WY,16022,592,715,14,15307,578,7,0,68,8,1,,,,,487,B
20200514,AK,31762,1113,387,4,31375,1109,10,0,,12,0,,,,,339,B
20200514,AL,141985,5613,10968,351,131017,5262,467,18,1350,,33,,489,,291,,B
20200514,AR,75818,2603,4236,72,71582,2531,97,2,509,64,12,,,13,100,3277,A
20200514,AS,105,0,0,0,105,0,0,0,,,0,,,,,,C
20200514,AZ,134338,6588,12674,498,121664,6090,624,30,2595,781,52,323,,201,,3074,A+
20200514,CA,1104651,39059,73164,2023,1031487,37036,3032,98,,4655,0,1324,,,,,B
20200514,CO,114519,3269,20475,318,94044,2951,1062,53,3735,685,40,,,,,3217,A
20200514,CT,149562,6619,35464,609,114098,6010,3219,94,10946,1103,1557,,,,,6264,B
20200514,DC,32999,1341,6736,152,26263,1189,358,8,,397,0,,,90,,966,A
20200514,DE,36857,2104,7223,271,29634,1833,362,11,,273,0,,,,,3080,B
20200514,FL,608837,14074,43210,808,565627,13266,1948,50,7993,,158,,,,,,A+
20200514,GA,285881,11977,35858,526,250023,11451,1527,22,6345,,86,,1513,,,,A+
20200514,GU,4379,117,153,1,4226,116,5,0,,,0,,,,,124,C
20200514,HI,38881,516,638,3,38243,513,17,0,81,,0,,,,,563,B
20200514,IA,89294,3575,13675,386,75619,3189,318,12,,405,0,134,,93,,6231,A+
20200514,ID,33754,626,2324,31,31430,595,69,0,212,19,-2,,88,,,1557,B
20200514,IL,512037,22678,87937,3239,424100,19439,3928,136,,4473,0,1132,,689,,,A
20200514,IN,160239,6156,26053,580,134186,5576,1646,27,4389,1381,0,488,990,217,,,A+
20200514,KS,57628,0,7468,0,50160,0,164,0,704,,0,,238,,108,422,A
20200514,KY,117395,6761,7080,227,110315,6534,326,5,1835,377,10,215,784,,,2649,A+
20200514,LA,247588,9684,33489,827,214099,8857,2417,36,,1193,0,,,140,,22608,B
20200514,MA,424361,14329,82182,1685,342179,12644,5482,167,8207,2859,175,781,,,,,A+
20200514,MD,178454,4880,35903,1091,142551,3789,1935,54,6553,1538,149,569,,,,2569,B
20200514,ME,23657,50,1565,50,22092,0,69,3,207,37,3,18,,7,,958,B
20200514,MI,383693,16993,57036,578,326657,16415,5278,46,,1330,0,653,,515,,22686,A+
20200514,MN,148008,6734,16565,793,131443,5941,663,25,1915,498,64,203,663,,,8473,A+
20200514,MO,127110,2968,10317,175,116793,2793,562,20,,796,0,,,115,,,B
20200514,MP,3325,285,19,0,3306,285,2,0,,,0,,,,,12,D
20200514,MS,105326,5278,10483,393,94843,4885,480,15,1667,589,51,131,,72,,6268,A
20200514,MT,24549,697,462,0,24087,697,16,0,63,3,0,,,,,431,B
20200514,NC,219268,8811,16507,691,202761,8120,615,18,,507,0,,,,,9115,A
20200514,ND,50246,1301,1647,0,48599,1301,31,2,129,38,2,,,,,1007,C
20200514,NE,53341,3616,9075,383,44266,3233,107,4,,,0,,,,,,C
20200514,NH,39175,1959,3299,60,35876,1899,150,8,326,126,7,,97,,,1236,B
20200514,NJ,451696,10246,142704,1144,308992,9102,9946,244,,3958,0,1157,,898,,15642,A+
20200514,NM,115011,4722,5364,152,109647,4570,231,12,886,200,0,,,,,1515,C
20200514,NV,69484,2812,6499,105,62985,2707,358,3,,515,0,126,,75,,244,B
20200514,NY,1298757,39850,343051,2390,955706,37460,22170,157,85454,6706,446,2223,,1846,,59758,A
20200514,OH,233352,7498,26357,636,206995,6862,1534,51,4718,953,100,360,1268,253,,,B
20200514,OK,112183,3056,4962,110,107221,2946,284,6,858,217,10,102,,,,3660,A+
20200514,OR,84050,63,3479,63,80571,0,137,3,685,163,7,38,,17,,1406,A+
20200514,PA,311195,8326,59636,938,251559,7388,4218,275,,1983,0,,,446,,,C
20200514,PR,2427,98,2427,98,,0,117,2,,159,0,18,,5,,,B
20200514,RI,87198,2155,12431,228,74767,1927,468,6,1351,271,23,65,,42,,903,A+
20200514,SC,102535,9395,8189,262,94346,9133,371,16,1338,,0,,,,,4914,A
20200514,SD,26473,629,3792,60,22681,569,43,4,290,85,9,,,,,2437,B
20200514,TN,302317,9400,16699,329,285618,9071,287,14,1435,599,47,,,,,8881,A
20200514,TX,587313,30537,43851,1448,543462,29089,1216,58,,1648,0,,,,,24487,A
20200514,UT,160119,3333,6749,129,153370,3204,75,0,558,142,5,,187,,83,3566,B
20200514,VA,166830,5438,27813,1067,139017,4371,955,28,5211,1533,131,355,,201,,3678,A+
20200514,VI,1233,36,69,0,1164,36,6,0,,,0,,,,,61,C
20200514,VT,21428,790,931,1,20497,789,53,0,,18,0,,,,,792,B
20200514,WA,262568,5005,19424,245,243144,4760,975,13,,365,0,111,,,,,A
20200514,WI,135467,5907,12869,420,122598,5487,434,13,1939,507,31,121,478,,,5994,A+
20200514,WV,68713,2033,1427,29,67286,2004,60,2,,52,0,9,,5,,870,B
20200514,WY,15430,371,701,26,14729,345,7,0,67,8,0,,,,,480,B
20200513,AK,30649,688,383,0,30266,688,10,0,,12,0,,,,,338,B
20200513,AL,136372,3154,10617,307,125755,2847,449,20,1317,,30,,477,,284,,B
20200513,AR,73215,2771,4164,0,69051,2771,95,0,497,59,12,,,12,99,3220,A
20200513,AS,105,0,0,0,105,0,0,0,,,0,,,,,,C
20200513,AZ,127750,4908,12176,440,115574,4468,594,32,2543,755,39,292,,191,,2979,A+
20200513,CA,1065592,32222,71141,1759,994451,30463,2934,87,,4545,0,1314,,,,,B
20200513,CO,111250,2593,20157,278,91093,2315,1009,22,3695,688,32,,,,,3171,A
20200513,CT,142943,4519,34855,522,108088,3997,3125,84,9389,1158,0,,,,,5413,B
20200513,DC,31658,608,6584,99,25074,509,350,14,,423,0,,,82,,934,A
20200513,DE,34753,1462,6952,211,27801,1251,351,17,,282,0,,,,,2942,B
20200513,FL,594763,15159,42402,479,552361,14680,1898,49,7835,,181,,,,,,A+
20200513,GA,273904,11725,35332,697,238572,11028,1505,44,6259,,129,,1494,,,,A+
20200513,GU,4262,171,152,0,4110,171,5,0,,,0,,,,,124,C
20200513,HI,38365,426,635,1,37730,425,17,0,81,,0,,,,,563,B
20200513,IA,85719,4431,13289,377,72430,4054,306,17,,388,0,133,,101,,5954,A+
20200513,ID,33128,423,2293,33,30835,390,69,-1,214,20,4,,88,,,1536,B
20200513,IL,489359,17668,84698,1677,404661,15991,3792,191,,4563,0,1208,,714,,,A
20200513,IN,154083,3573,25473,346,128610,3227,1619,41,4389,1336,0,481,990,217,,,A+
20200513,KS,57628,3519,7468,352,50160,3167,164,6,704,,44,,238,,108,422,A
20200513,KY,110634,6610,6853,176,103781,6434,321,10,1825,379,58,215,783,,,2546,A+
20200513,LA,237904,9892,32662,612,205242,9280,2381,34,,1194,0,,,147,,22608,B
20200513,MA,410032,8536,80497,1165,329535,7371,5315,174,8032,3101,190,794,,,,,A+
20200513,MD,173574,4071,34812,751,138762,3320,1881,47,6404,1550,117,572,,,,2456,B
20200513,ME,23607,38,1515,38,22092,0,66,1,204,41,2,20,,7,,943,B
20200513,MI,366700,19358,56458,817,310242,18541,5232,44,,1384,0,693,,525,,22686,A+
20200513,MN,141274,7297,15772,729,125502,6568,638,24,1851,494,52,199,647,,,8149,A+
20200513,MO,124142,2846,10142,136,114000,2710,542,18,,771,0,,,129,,,B
20200513,MP,3040,167,19,0,3021,167,2,0,,,0,,,,,12,D
20200513,MS,100048,2356,10090,182,89958,2174,465,8,1616,604,34,150,,79,,6268,A
20200513,MT,23852,817,462,1,23390,816,16,0,63,3,0,,,,,430,B
20200513,NC,210457,8213,15816,470,194641,7743,597,20,,521,0,,,,,9115,A
20200513,ND,48945,1113,1647,76,47298,1037,29,4,127,37,5,,,,,969,C
20200513,NE,49725,1782,8692,120,41033,1662,103,3,,192,0,81,,56,,,B
20200513,NH,37216,1655,3239,79,33977,1576,142,9,319,121,1,,97,,,1234,B
20200513,NJ,441450,8390,141560,817,299890,7573,9702,194,,4226,0,1226,,928,,15642,A+
20200513,NM,110289,3568,5212,143,105077,3425,219,11,886,199,0,,,,,1434,C
20200513,NV,66672,2597,6394,83,60278,2514,355,5,,522,0,121,,64,,198,B
20200513,NY,1258907,33794,340661,2176,918246,31618,22013,168,85008,6946,519,2308,,1908,,59193,A
20200513,OH,225854,8123,25721,471,200133,7652,1483,47,4618,924,79,353,1248,244,,,B
20200513,OK,109127,13016,4852,120,104275,12896,278,0,848,218,20,93,,,,3559,A+
20200513,OR,83987,6381,3416,130,80571,6251,134,4,678,162,5,38,,17,,1406,A+
20200513,PA,302869,6889,58698,707,244171,6182,3943,137,,2012,0,,,473,,,C
20200513,PR,2329,30,2329,30,,0,115,1,,142,0,10,,6,,,C
20200513,RI,85043,2120,12203,196,72840,1924,462,18,1328,269,21,68,,48,,886,A+
20200513,SC,93140,0,7927,0,85213,0,355,0,1338,,0,,,,,6817,A
20200513,SD,25844,647,3732,69,22112,578,39,0,281,79,10,,,,,2367,B
20200513,TN,292917,9093,16370,259,276547,8834,273,8,1388,635,25,,,,,8624,A
20200513,TX,556776,18604,42403,1355,514373,17249,1158,25,,1676,0,,,,,23519,A
20200513,UT,156786,3301,6620,188,150166,3113,75,2,553,158,18,,182,,81,3406,B
20200513,VA,161392,6063,26746,946,134646,5117,927,36,5080,1526,151,374,,202,,3554,A+
20200513,VI,1197,13,69,0,1128,13,6,0,,,0,,,,,61,C
20200513,VT,20638,602,930,1,19708,601,53,0,,17,0,,,,,789,B
20200513,WA,257563,4747,19179,227,238384,4520,962,17,,384,0,114,,,,,A
20200513,WI,129560,4681,12449,318,117111,4363,421,3,1908,527,31,110,469,,,5673,A+
20200513,WV,66680,1611,1398,27,65282,1584,58,1,,58,0,11,,6,,813,B
20200513,WY,15059,0,675,0,14384,0,7,0,67,10,0,,,,,477,B
20200512,AK,29961,1281,383,2,29578,1279,10,0,,10,0,,,,,334,B
20200512,AL,133218,3774,10310,301,122908,3473,429,28,1287,,31,,468,,280,,B
20200512,AR,70444,1414,4164,130,66280,1284,95,1,485,59,5,,,12,98,3220,A
20200512,AS,105,0,0,0,105,0,0,0,,,0,,,,,,C
20200512,AZ,122842,6378,11736,356,111106,6022,562,20,2504,765,42,318,,204,,2909,A+
20200512,CA,1033370,41473,69382,1443,963988,40030,2847,77,,4544,0,1349,,,,,B
20200512,CO,108657,-133,19879,-20,88778,-113,987,6,3663,738,-26,,,,,3114,A
20200512,CT,138424,5916,34333,568,104091,5348,3041,33,9389,1189,0,,,,,5413,B
20200512,DC,31050,789,6485,96,24565,693,336,8,,416,0,,,82,,886,A
20200512,DE,33291,1363,6741,176,26550,1187,334,10,,276,0,,,,,2802,B
20200512,FL,579604,18547,41923,941,537681,17606,1849,44,7654,,196,,,,,,A+
20200512,GA,262179,10891,34635,708,227544,10183,1461,20,6130,,115,,1443,,,,A+
20200512,GU,4091,102,152,1,3939,101,5,0,,,0,,,,,124,C
20200512,HI,37939,256,634,2,37305,254,17,0,81,,0,,,,,561,B
20200512,IA,81288,3496,12912,539,68376,2957,289,18,,385,0,143,,101,,5618,A+
20200512,ID,32705,563,2260,30,30445,533,70,3,210,25,3,,87,,,1508,B
20200512,IL,471691,29266,83021,4014,388670,25252,3601,142,,4626,0,1215,,730,,,A
20200512,IN,150510,3822,25127,500,125383,3322,1578,38,4389,1283,0,472,,212,,,A+
20200512,KS,54109,0,7116,0,46993,0,158,0,660,,0,,233,,101,376,A
20200512,KY,104024,17101,6677,237,97347,16864,311,7,1767,383,10,220,768,,,2335,A+
20200512,LA,228012,7182,32050,235,195962,6947,2347,39,,1320,0,,,146,,22608,B
20200512,MA,401496,6768,79332,870,322164,5898,5141,33,7842,3127,110,818,,,,,A+
20200512,MD,169503,4723,34061,688,135442,4035,1834,46,6287,1563,104,590,,,,2394,B
20200512,ME,23569,15,1477,15,22092,0,65,0,202,34,2,17,,8,,913,B
20200512,MI,347342,15045,55641,1637,291701,13408,5188,49,,1384,0,693,,525,,22686,A+
20200512,MN,133977,4013,15043,664,118934,3349,614,23,1799,496,83,199,625,,,7609,A
20200512,MO,121296,5676,10006,88,111290,5588,524,36,,787,0,,,140,,,B
20200512,MP,2873,178,19,0,2854,178,2,0,,,0,,,,,12,D
20200512,MS,97692,1807,9908,234,87784,1573,457,22,1582,604,36,146,,75,,6268,A
20200512,MT,23035,463,461,2,22574,461,16,0,63,4,1,,,,,425,B
20200512,NC,202244,6379,15346,301,186898,6078,577,27,,475,0,,,,,9115,A
20200512,ND,47832,818,1571,53,46261,765,25,1,122,38,7,,,,,877,C
20200512,NE,47943,1704,8572,257,39371,1447,100,2,,192,0,81,,56,,,B
20200512,NH,35561,678,3160,0,32401,678,133,0,318,117,0,,97,,,1231,B
20200512,NJ,433060,7127,140743,798,292317,6329,9508,198,,4328,0,1306,,982,,15642,A+
20200512,NM,106721,4223,5069,206,101652,4017,208,8,886,207,97,,,,,1300,C
20200512,NV,64075,3991,6311,159,57764,3832,350,6,,522,0,121,,64,,185,C
20200512,NY,1225113,20462,338485,1430,886628,19032,21845,205,84489,7063,295,2375,,1964,,58679,A
20200512,OH,217731,7201,25250,473,192481,6728,1436,79,4539,1032,126,401,1232,270,,,B
20200512,OK,96111,119,4732,119,91379,0,278,4,828,190,0,83,,,,3423,A+
20200512,OR,77606,0,3286,0,74320,0,130,0,673,165,0,39,,25,,1125,A+
20200512,PA,295980,7122,57991,837,237989,6285,3806,75,,2187,0,,,497,,,C
20200512,PR,2299,43,2299,43,,0,114,1,,127,0,,,,,,C
20200512,RI,82923,1770,12007,219,70916,1551,444,14,1307,277,27,72,,53,,863,A+
20200512,SC,93140,8683,7927,274,85213,8409,355,24,1338,,86,,,,,6817,A
20200512,SD,25197,619,3663,49,21534,570,39,5,271,74,8,,,,,2309,B
20200512,TN,283824,10547,16111,567,267713,9980,265,14,1363,591,19,,,,,8336,A
20200512,TX,538172,12475,41048,1179,497124,11296,1133,33,,1725,0,,,,,22674,A
20200512,UT,153485,2900,6432,70,147053,2830,73,5,535,166,18,,178,,80,3267,B
20200512,VA,155329,4712,25800,730,129529,3982,891,41,4929,1529,152,364,,201,,3400,A+
20200512,VI,1184,5,69,0,1115,5,6,1,,,0,,,,,61,C
20200512,VT,20036,312,929,2,19107,310,53,0,,18,0,,,,,787,B
20200512,WA,252816,4976,18952,211,233864,4765,945,14,,321,0,94,,,,,A
20200512,WI,124879,4926,12131,211,112748,4715,418,9,1877,520,31,116,464,,,5371,A+
20200512,WV,65069,1600,1371,5,63698,1595,57,3,,50,0,9,,5,,803,C
20200512,WY,15059,2994,675,13,14384,2981,7,0,67,10,1,,,,,477,B
20200511,AK,28680,1316,381,2,28299,1314,10,0,,7,0,,,,,328,C
20200511,AL,129444,2023,10009,232,119435,1791,401,8,1256,,16,,463,,276,,B
20200511,AR,69030,3502,4034,287,64996,3215,94,6,480,61,9,,,11,98,3149,A
20200511,AS,105,22,0,0,105,22,0,0,,,0,,,,,,D
20200511,AZ,116464,6087,11380,261,105084,5826,542,6,2462,717,41,297,,201,,2852,A+
20200511,CA,991897,36233,67939,1259,923958,34974,2770,25,,4549,0,1329,,,,,B
20200511,CO,108790,4713,19899,196,88891,4517,981,14,3689,573,66,,,,,3076,B
20200511,CT,132508,2316,33765,211,98743,2105,3008,41,9389,1212,0,,,,,5413,B
20200511,DC,30261,691,6389,117,23872,574,328,5,,416,0,,,82,,881,A
20200511,DE,31928,889,6565,118,25363,771,324,12,,275,0,,,,,2619,B
20200511,FL,561057,22109,40982,386,520075,21723,1805,14,7458,,54,,,,,,B
20200511,GA,251288,7741,33927,486,217361,7255,1441,36,6015,,18,,1414,,,,A
20200511,GU,3989,195,151,0,3838,195,5,0,,,0,,,,,124,C
20200511,HI,37683,413,632,1,37051,412,17,0,81,,0,,,,,561,B
20200511,IA,77792,3618,12373,414,65419,3204,271,6,,394,0,152,,107,,5249,A+
20200511,ID,32142,0,2230,0,29912,0,67,0,207,30,0,,87,,,1473,B
20200511,IL,442425,12441,79007,1266,363418,11175,3459,53,,4319,0,1248,,730,,,A
20200511,IN,146688,6659,24627,501,122061,6158,1540,32,4389,1346,0,452,990,213,,,A+
20200511,KS,54109,1604,7116,168,46993,1436,158,1,660,,3,,233,,101,376,A
20200511,KY,86923,0,6440,0,80483,0,304,0,1757,394,0,226,758,,,2308,A
20200511,LA,220830,4958,31815,215,189015,4743,2308,22,,1310,0,,,157,,22608,B
20200511,MA,394728,6339,78462,669,316266,5670,5108,129,7732,3102,115,813,,,,,A
20200511,MD,164780,4849,33373,786,131407,4063,1788,49,6183,1544,228,585,,,,2298,A
20200511,ME,23554,26,1462,26,22092,0,65,1,200,37,1,17,,9,,872,B
20200511,MI,332297,11847,54004,971,278293,10876,5139,58,,1424,0,685,,557,,22686,A+
20200511,MN,129964,5303,14379,827,115585,4476,591,13,1716,452,59,194,600,,,6945,A
20200511,MO,115620,74,9918,74,105702,0,488,6,,824,0,,,137,,,B
20200511,MP,2695,358,19,3,2676,355,2,0,,,0,,,,,12,D
20200511,MS,95885,14283,9674,173,86211,14110,435,5,1546,507,15,132,,68,,6268,A
20200511,MT,22572,868,459,1,22113,867,16,0,62,4,0,,,,,423,C
20200511,NC,195865,3730,15045,281,180820,3449,550,3,,464,0,,,,,9115,B
20200511,ND,47014,2145,1518,27,45496,2118,24,0,115,34,5,,,,,846,C
20200511,NE,46239,670,8315,81,37924,589,98,2,,,0,,,,,,D
20200511,NH,34883,1430,3160,149,31723,1281,133,2,318,113,5,,97,,,1229,B
20200511,NJ,425933,113486,139945,1413,285988,112073,9310,55,,4195,0,1255,,970,,15642,A+
20200511,NM,102498,5445,4863,85,97635,5360,200,9,789,194,0,,,,,1285,C
20200511,NV,60084,1275,6152,54,53932,1221,344,5,,482,0,117,,60,,183,C
20200511,NY,1204651,21653,337055,1660,867596,19993,21640,162,84194,7226,433,2450,,2020,,58363,A
20200511,OH,210530,5668,24777,696,185753,4972,1357,16,4413,1011,62,391,1217,256,,,B
20200511,OK,95992,24,4613,24,91379,0,274,2,828,177,2,93,,,,3241,A+
20200511,OR,77606,2099,3286,58,74320,2041,130,3,673,164,3,40,,23,,1125,A+
20200511,PA,288858,4475,57154,543,231704,3932,3731,24,,2176,0,,,497,,,C
20200511,PR,2256,58,2256,58,,0,113,2,,159,0,,,,,,D
20200511,RI,81153,1434,11788,175,69365,1259,430,8,1280,276,29,73,,52,,841,A+
20200511,SC,84457,0,7653,0,76804,0,331,0,1252,,0,,,,,4120,B
20200511,SD,24578,684,3614,97,20964,587,34,0,263,78,2,,,,,2187,C
20200511,TN,273277,11408,15544,559,257733,10849,251,8,1344,581,19,,,,,8038,B
20200511,TX,525697,23921,39869,1000,485828,22921,1100,12,,1525,0,,,,,21713,B
20200511,UT,150585,4075,6362,111,144223,3964,68,1,517,160,5,,169,,76,3181,B
20200511,VA,150617,7562,25070,989,125547,6573,850,11,4777,1504,21,362,,194,,3273,A+
20200511,VI,1179,8,69,0,1110,8,5,1,,,0,,,,,60,C
20200511,VT,19724,631,927,1,18797,630,53,0,,14,0,,,,,785,B
20200511,WA,247840,4843,18741,292,229099,4551,931,10,,350,0,110,,,,,B
20200511,WI,119953,3096,11920,226,108033,2870,409,9,1846,520,26,116,460,,,5176,A+
20200511,WV,63469,825,1366,6,62103,819,54,0,,49,0,10,,6,,775,C
20200511,WY,12065,1,662,1,11403,0,7,0,66,12,1,,,,,443,C
20200510,AK,27364,915,379,1,26985,914,10,0,,8,0,,,,,324,C
20200510,AL,127421,1927,9777,210,117644,1717,393,5,1240,,12,,460,,274,,B
20200510,AR,65528,0,3747,0,61781,0,88,0,471,64,0,,,14,96,2968,B
20200510,AS,83,0,0,0,83,0,0,0,,,0,,,,,,D
20200510,AZ,110377,4567,11119,159,99258,4408,536,4,2421,713,35,300,,195,,2775,A+
20200510,CA,955664,43094,66680,2119,888984,40975,2745,67,,4555,0,1328,,,,,B
20200510,CO,104077,7305,19703,876,84374,6429,967,7,3623,790,23,,,,,3023,B
20200510,CT,130192,6623,33554,570,96638,6053,2967,35,9389,1242,0,,,,,5413,B
20200510,DC,29570,1387,6272,170,23298,1217,323,12,,447,0,130,,91,,880,A+
20200510,DE,31039,1743,6447,170,24592,1573,312,11,,285,0,,,,,2537,B
20200510,FL,538948,11217,40596,595,498352,10622,1791,6,7404,,79,,,,,,B
20200510,GA,243547,8223,33441,909,210106,7314,1405,5,5997,,10,,1412,,,,A
20200510,GU,3794,0,151,0,3643,0,5,0,,,0,,,,,124,C
20200510,HI,37270,1008,631,2,36639,1006,17,0,81,,0,,,,,551,B
20200510,IA,74174,2698,11959,288,62215,2410,265,13,,413,0,157,,105,,5154,A+
20200510,ID,32142,336,2230,25,29912,311,67,0,207,25,1,,87,,,1473,B
20200510,IL,429984,13653,77741,1656,352243,11997,3406,57,,4293,0,1232,,709,,,A
20200510,IN,140029,4343,24126,394,115903,3949,1508,18,4389,1328,0,462,990,205,,,A+
20200510,KS,52505,2572,6948,197,45557,2375,157,0,657,,22,,231,,101,371,A
20200510,KY,86923,476,6440,152,80483,324,304,6,1757,394,61,226,758,,,2308,A
20200510,LA,215872,3715,31600,183,184272,3532,2286,19,,1324,0,,,161,,20316,B
20200510,MA,388389,11852,77793,1050,310596,10802,4979,139,7617,3128,66,810,,,,,A
20200510,MD,159931,3903,32587,1053,127344,2850,1739,47,5955,1640,23,611,,,,2293,A
20200510,ME,23528,28,1436,28,22092,0,64,0,199,36,1,17,,10,,861,B
20200510,MI,320450,8453,53033,301,267417,8152,5081,45,,1437,0,674,,536,,22686,A+
20200510,MN,124661,5300,13552,231,111109,5069,578,20,1657,434,45,199,581,,,6304,A
20200510,MO,115546,6648,9844,178,105702,6470,482,10,,824,0,,,137,,,B
20200510,MP,2337,0,16,0,2321,0,2,0,,,0,,,,,12,D
20200510,MS,81602,123,9501,123,72101,0,430,9,1531,645,19,141,,78,,4421,A
20200510,MT,21704,375,458,0,21246,375,16,0,62,4,0,,,,,422,C
20200510,NC,192135,5773,14764,404,177371,5369,547,3,,442,0,,,,,,B
20200510,ND,44869,936,1491,27,43378,909,24,0,110,29,0,,,,,792,C
20200510,NE,45569,2593,8234,403,37335,2190,96,4,,,0,,,,,,D
20200510,NH,33453,1155,3011,64,30442,1091,131,10,313,107,4,,97,,,1228,B
20200510,NJ,312447,7241,138532,1447,173915,5794,9255,139,,4308,0,1338,,994,,15642,A+
20200510,NM,97053,3791,4778,105,92275,3686,191,10,789,198,0,,,,,1268,C
20200510,NV,58809,2698,6098,70,52711,2628,339,5,,444,0,116,,65,,182,C
20200510,NY,1182998,29230,335395,2273,847603,26957,21478,207,83761,7262,476,2488,,2073,,58006,A
20200510,OH,204862,8192,24081,384,180781,7808,1341,10,4351,962,51,381,1205,254,,,B
20200510,OK,95968,99,4589,99,91379,0,272,2,826,177,4,93,,,,3204,A+
20200510,OR,75507,887,3228,68,72279,819,127,0,670,164,8,45,,22,,1125,A+
20200510,PA,284383,7276,56611,1295,227772,5981,3707,19,,2230,0,,,501,,,C
20200510,PR,2198,25,2198,25,,0,111,3,,143,0,,,,,,D
20200510,RI,79719,1688,11613,186,68106,1502,422,4,1251,283,33,70,,52,,809,A+
20200510,SC,84457,3494,7653,122,76804,3372,331,1,1252,,0,,,,,4120,B
20200510,SD,23894,942,3517,124,20377,818,34,0,261,77,8,,,,,2147,C
20200510,TN,261869,9121,14985,217,246884,8904,243,1,1325,484,6,,,,,7528,B
20200510,TX,501776,12482,38869,1009,462907,11473,1088,39,,1626,0,,,,,21022,B
20200510,UT,146510,3216,6251,148,140259,3068,67,1,512,144,14,,168,,76,3033,B
20200510,VA,143055,5906,24081,885,118974,5021,839,12,4756,1555,39,351,,187,,3201,A+
20200510,VI,1171,79,69,1,1102,78,4,0,,,0,,,,,59,C
20200510,VT,19093,477,926,0,18167,477,53,0,,21,0,,,,,777,B
20200510,WA,242997,1361,18449,174,224548,1187,921,16,,335,0,101,,,,,B
20200510,WI,116857,3520,11694,292,105163,3228,400,2,1820,514,14,113,456,,,5014,A+
20200510,WV,62644,1647,1360,25,61284,1622,54,1,,49,0,10,,6,,775,C
20200510,WY,12064,17,661,17,11403,0,7,0,65,12,1,,,,,443,C
20200509,AK,26449,976,378,1,26071,975,10,0,,8,0,,,,,318,C
20200509,AL,125494,5380,9567,346,115927,5034,388,13,1228,,21,,459,,272,,B
20200509,AR,65528,1534,3747,53,61781,1481,88,0,471,64,5,,,14,96,2968,B
20200509,AS,83,0,0,0,83,0,0,0,,,0,,,,,,D
20200509,AZ,105810,4685,10960,434,94850,4251,532,15,2386,739,36,296,,186,,2684,A+
20200509,CA,912570,37298,64561,2049,848009,35249,2678,93,,4538,0,1349,,,,,B
20200509,CO,96772,2236,18827,26,77945,2210,960,-1,3600,790,43,,,,,2974,B
20200509,CT,123569,3028,32984,573,90585,2455,2932,58,9389,1301,0,,,,,5413,B
20200509,DC,28183,1068,6102,203,22081,865,311,7,,447,0,130,,91,,879,A+
20200509,DE,29296,1032,6277,166,23019,866,301,4,,288,0,,,,,2450,B
20200509,FL,527731,14390,40001,802,487730,13588,1785,47,7325,,168,,,,,,B
20200509,GA,235324,7757,32532,426,202792,7331,1400,23,5987,,52,,1409,,,,A
20200509,GU,3794,17,151,0,3643,17,5,0,,,0,,,,,124,C
20200509,HI,36262,-356,629,0,35633,-356,17,0,81,,7,,,,,566,C
20200509,IA,71476,1215,11671,214,59805,1001,252,9,,402,0,161,,106,,5011,A+
20200509,ID,31806,536,2205,27,29601,509,67,0,206,19,0,,86,,,1442,B
20200509,IL,416331,16617,76085,2325,340246,14292,3349,108,,4739,0,1215,,739,,,A
20200509,IN,135686,5558,23732,586,111954,4972,1490,43,4389,1361,0,458,990,213,,,A+
20200509,KS,49933,2225,6751,250,43182,1975,157,5,635,,27,,229,,100,350,A
20200509,KY,86447,5046,6288,159,80159,4887,298,4,1696,369,12,210,723,,,2266,A
20200509,LA,212157,9741,31417,562,180740,9179,2267,40,,1333,0,,,165,,20316,B
20200509,MA,376537,10514,76743,1410,299794,9104,4840,138,7551,3229,117,814,,,,,A
20200509,MD,156028,3841,31534,1049,124494,2792,1692,49,5932,1665,121,575,,,,2159,A
20200509,ME,23500,34,1408,34,22092,0,64,1,198,43,4,22,,10,,857,B
20200509,MI,311997,11506,52732,383,259265,11123,5036,49,,1531,0,683,,539,,22686,A+
20200509,MN,119361,4913,13321,281,106040,4632,558,24,1612,476,63,180,556,,,5764,A
20200509,MO,108898,177,9666,177,99232,0,472,23,,855,0,,,144,,,B
20200509,MP,2337,1,16,1,2321,0,2,0,,,0,,,,,12,D
20200509,MS,81479,288,9378,288,72101,0,421,12,1512,607,34,133,,76,,4421,A
20200509,MT,21329,384,458,0,20871,384,16,0,62,4,0,,,,,422,C
20200509,NC,186362,7749,14360,492,172002,7257,544,17,,513,0,,,,,,B
20200509,ND,43933,1432,1464,39,42469,1393,24,0,110,34,6,,,,,762,C
20200509,NE,42976,2564,7831,641,35145,1923,92,2,,,0,,,,,,D
20200509,NH,32298,1626,2947,104,29351,1522,121,7,309,112,1,,97,,,1210,B
20200509,NJ,305206,6447,137085,1631,168121,4816,9116,164,,4628,0,1416,,1054,,15642,A+
20200509,NM,93262,4230,4673,180,88589,4050,181,9,789,201,29,,,,,1189,C
20200509,NV,56111,2767,6028,144,50083,2623,334,6,,,0,,,,,205,D
20200509,NY,1153768,32225,333122,2715,820646,29510,21271,226,83285,7776,555,2664,,2203,,57180,B
20200509,OH,196670,12354,23697,681,172973,11673,1331,25,4300,929,82,368,1200,222,,,B
20200509,OK,95869,6012,4490,66,91379,5946,270,4,822,177,17,93,,,,3154,A+
20200509,OR,74620,1927,3160,92,71460,1835,127,3,662,139,3,34,,19,,1125,A+
20200509,PA,277107,6548,55316,1078,221791,5470,3688,72,,2285,0,,,502,,,C
20200509,PR,2173,17,2173,17,,0,108,1,,148,0,,,7,,,C
20200509,RI,78031,2552,11427,286,66604,2266,418,19,1218,292,31,77,,56,,772,A+
20200509,SC,80963,7521,7531,389,73432,7132,330,14,1252,,100,,,,,4120,B
20200509,SD,22952,1659,3393,249,19559,1410,34,3,253,79,6,,,,,2125,C
20200509,TN,252748,9170,14768,327,237980,8843,242,1,1319,509,20,,,,,7369,B
20200509,TX,489294,12176,37860,1251,451434,10925,1049,45,,1735,0,,,,,20141,B
20200509,UT,143294,4606,6103,184,137191,4422,66,5,498,172,10,,166,,75,2901,B
20200509,VA,137149,7204,23196,854,113953,6350,827,15,4717,1593,95,367,,198,,3124,A+
20200509,VI,1092,0,68,0,1024,0,4,0,,,0,,,,,57,C
20200509,VT,18616,476,926,8,17690,468,53,0,,21,0,,,,,744,B
20200509,WA,241636,2094,18275,151,223361,1943,905,14,,393,0,128,,,,,B
20200509,WI,113337,5042,11402,372,101935,4670,398,14,1806,543,39,110,452,,,4875,A+
20200509,WV,60997,1561,1335,25,59662,1536,53,2,,53,0,13,,7,,761,C
20200509,WY,12047,9,644,9,11403,0,7,0,64,12,4,,,,,438,C
20200508,AK,25473,1132,377,3,25096,1129,10,0,,16,0,,,,,305,C
20200508,AL,120114,4941,9221,323,110893,4618,375,26,1207,,29,,454,,266,,B
20200508,AR,63994,3999,3694,83,60300,3916,88,1,466,70,4,,,14,93,2159,B
20200508,AS,83,0,0,0,83,0,0,0,,,0,,,,,,F
20200508,AZ,101125,4691,10526,581,90599,4110,517,67,2350,730,58,295,,197,,1747,A+
20200508,CA,875272,32398,62512,1898,812760,30500,2585,81,,4514,0,1342,,,,,B
20200508,CO,94536,3189,18801,971,75735,2218,961,40,3557,821,571,,,,,2869,B
20200508,CT,120541,4367,32411,627,88130,3740,2874,77,9389,1327,0,,,,,5413,B
20200508,DC,27115,1259,5899,245,21216,1014,304,19,,447,0,130,,91,,825,A+
20200508,DE,28264,938,6111,172,22153,766,297,12,,289,0,,,,,2288,B
20200508,FL,513341,20391,39199,371,474142,20020,1738,71,7157,,167,,,,,,C
20200508,GA,227567,10264,32106,667,195461,9597,1377,41,5935,,100,,1399,,,,A
20200508,GU,3777,62,151,0,3626,62,5,0,,,0,,,,,122,D
20200508,HI,36618,1077,629,3,35989,1074,17,0,74,,0,,,,,565,B
20200508,IA,70261,3834,11457,398,58804,3436,243,12,,407,0,164,,109,,4685,A+
20200508,ID,31270,380,2178,20,29092,360,67,1,206,16,1,,86,,,1420,B
20200508,IL,399714,20671,73760,2887,325954,17784,3241,130,,4750,0,1222,,727,,,A
20200508,IN,130128,5346,23146,643,106982,4703,1447,33,4389,1379,4389,481,990,219,,,A+
20200508,KS,47708,2886,6501,357,41207,2529,152,5,608,,21,,223,,99,332,A
20200508,KY,81401,2795,6129,195,75272,2600,294,11,1684,356,68,199,714,,,2177,A
20200508,LA,202416,1649,30855,203,171561,1446,2227,19,,1359,0,,,185,,20316,B
20200508,MA,366023,14391,75333,1612,290690,12779,4702,150,7434,3349,197,826,,,,,A
20200508,MD,152187,3587,30485,1111,121702,2476,1643,63,5811,1674,148,571,,,,2041,A
20200508,ME,23466,44,1374,44,22092,0,63,1,194,44,2,23,,10,,836,B
20200508,MI,300491,12576,52349,618,248142,11958,4987,62,,1637,0,725,,570,,15659,A+
20200508,MN,114448,4876,13040,712,101408,4164,534,26,1549,473,90,198,540,,,5163,A
20200508,MO,108721,5099,9489,148,99232,4951,449,31,,832,0,,,143,,,B
20200508,MP,2336,538,15,0,2321,538,2,0,,,0,,,,,12,D
20200508,MS,81191,404,9090,404,72101,0,409,13,1478,632,36,123,,58,,4421,A
20200508,MT,20945,698,458,2,20487,696,16,0,62,6,0,,,,,420,C
20200508,NC,178613,7285,13868,471,164745,6814,527,20,,515,0,,,,,,B
20200508,ND,42501,1634,1425,54,41076,1580,24,1,104,33,2,,,,,714,C
20200508,NE,40412,2654,7190,419,33222,2235,90,4,,,0,,,,,,D
20200508,NH,30672,1866,2843,103,27829,1763,114,3,308,113,1,,97,,,1165,B
20200508,NJ,298759,6101,135454,1819,163305,4282,8952,151,,4605,0,1439,,1089,,15642,A+
20200508,NM,89032,3348,4493,202,84539,3146,172,3,760,197,73,,,,,1125,C
20200508,NV,53344,1987,5884,118,47460,1869,328,8,,,0,,,,,205,D
20200508,NY,1121543,31627,330407,2758,791136,28869,21045,217,82730,8196,533,2811,,2295,,56378,B
20200508,OH,184316,8257,23016,885,161300,7372,1306,35,4218,1060,78,393,1188,274,,,B
20200508,OK,89857,2970,4424,94,85433,2876,266,6,805,228,0,96,,,,3064,A+
20200508,OR,72693,2235,3068,79,69625,2156,124,3,659,159,14,42,,18,,1125,A+
20200508,PA,270559,7771,54238,1323,216321,6448,3616,200,,2342,0,,,517,,,C
20200508,PR,2156,125,2156,125,,0,107,5,,161,0,,,10,,,C
20200508,RI,75479,1922,11141,231,64338,1691,399,11,1187,312,34,71,,52,,730,A+
20200508,SC,73442,-4040,7142,206,66300,-4246,316,11,1152,,0,,,,,3816,B
20200508,SD,21293,1179,3144,239,18149,940,31,0,247,76,11,,,,,2069,C
20200508,TN,243578,7250,14441,345,229137,6905,241,4,1299,550,33,,,,,7011,B
20200508,TX,477118,21956,36609,1219,440509,20737,1004,31,,1734,0,,,,,19197,B
20200508,UT,138688,4145,5919,195,132769,3950,61,0,488,216,12,,162,,73,2769,B
20200508,VA,129945,6793,22342,772,107603,6021,812,43,4622,1625,184,378,,199,,2997,A+
20200508,VI,1092,36,68,2,1024,34,4,0,,,0,,,,,57,C
20200508,VT,18140,534,918,2,17222,532,53,0,,15,0,,,,,737,B
20200508,WA,239542,5175,18124,210,221418,4965,891,21,,393,0,122,,,,,B
20200508,WI,108295,4639,11030,409,97265,4230,384,10,1767,552,35,110,441,,,4694,A+
20200508,WV,59436,1915,1310,23,58126,1892,51,0,,65,0,19,,11,,761,C
20200508,WY,12038,4,635,4,11403,0,7,0,60,9,1,,,,,428,C
20200507,AK,24341,686,374,2,23967,684,10,0,,12,0,,,,,291,C
20200507,AL,115173,5657,8898,317,106275,5340,349,9,1178,,20,,448,,266,,B
20200507,AR,59995,992,3611,43,56384,949,87,2,462,69,9,,,14,93,2123,B
20200507,AS,83,0,0,0,83,0,0,0,,,0,,,,,,F
20200507,AZ,96434,4697,9945,238,86489,4459,450,24,2292,766,48,288,,196,,1722,A+
20200507,CA,842874,33838,60614,1799,782260,32039,2504,92,,4560,0,1374,,,,,B
20200507,CO,91347,5371,17830,466,73517,4905,921,18,2986,798,67,,,,,2869,B
20200507,CT,116174,4727,31784,789,84390,3938,2797,79,9389,1385,1631,,,,,5413,B
20200507,DC,25856,872,5654,193,20202,679,285,8,,447,0,130,,91,,825,A+
20200507,DE,27326,858,5939,161,21387,697,285,16,,285,0,,,,,2110,B
20200507,FL,492950,12899,38828,826,454122,12073,1667,62,6990,,214,,,,,,C
20200507,GA,217303,13166,31439,743,185864,12423,1336,25,5835,,70,,1374,,,,A
20200507,GU,3715,88,151,0,3564,88,5,0,,,0,,,,,123,F
20200507,HI,35541,342,626,1,34915,341,17,0,74,,1,,,,,558,B
20200507,IA,66427,3256,11059,655,55368,2601,231,12,,417,0,151,,107,,4266,A+
20200507,ID,30890,345,2158,31,28732,314,66,1,205,20,2,,86,,,1399,B
20200507,IL,379043,17783,70873,2641,308170,15142,3111,137,,4862,0,1253,,766,,,A
20200507,IN,124782,4286,22503,633,102279,3653,1414,37,,1457,0,487,,228,,,A+
20200507,KS,44822,2708,6144,410,38678,2298,147,3,587,,16,,218,,97,323,A
20200507,KY,78606,17592,5934,112,72672,17480,283,8,1616,351,13,190,693,,,2125,A
20200507,LA,200767,6095,30652,253,170115,5842,2208,93,,1432,0,,,189,,20316,B
20200507,MA,351632,11993,73721,1696,277911,10297,4552,132,7237,3436,157,852,,,,,A
20200507,MD,148600,4588,29374,1211,119226,3377,1580,60,5663,1683,166,584,,,,2029,A
20200507,ME,23422,76,1330,76,22092,0,62,0,192,39,1,16,,11,,787,B
20200507,MI,287915,12221,51731,600,236184,11621,4925,86,,1697,0,753,,612,,15659,A+
20200507,MN,109572,5015,12328,818,97244,4197,508,23,1459,435,54,182,512,,,4800,A
20200507,MO,103622,2875,9341,239,94281,2636,418,22,,917,0,,,141,,,B
20200507,MP,1798,0,15,0,1783,0,2,0,,,0,,,,,12,D
20200507,MS,80787,262,8686,262,72101,0,396,22,1442,650,50,139,,71,,4421,A
20200507,MT,20247,543,456,0,19791,543,16,0,62,6,0,,,,,417,C
20200507,NC,171328,6846,13397,639,157931,6207,507,30,,525,0,,,,,,B
20200507,ND,40867,2235,1371,48,39496,2187,23,1,102,35,5,,,,,601,C
20200507,NE,37758,1630,6771,333,30987,1297,86,4,,,0,,,,,,D
20200507,NH,28806,1073,2740,104,26066,969,111,19,307,113,12,,82,,,1110,B
20200507,NJ,292658,3738,133635,1745,159023,1993,8801,252,,4996,0,1470,,1107,,15642,A+
20200507,NM,85684,2433,4291,153,81393,2280,169,7,687,193,0,,,,,1073,C
20200507,NV,51357,2082,5766,103,45591,1979,320,9,,,0,,,,,205,D
20200507,NY,1089916,33995,327649,3671,762267,30324,20828,951,82197,8665,627,2976,,2425,,55547,B
20200507,OH,176059,7130,22131,555,153928,6575,1271,46,4140,1057,88,418,1167,279,,,B
20200507,OK,86887,3997,4330,129,82557,3868,260,7,805,223,32,97,,,,2985,A+
20200507,OR,70458,2482,2989,73,67469,2409,121,6,645,171,4,48,,23,,1125,A+
20200507,PA,262788,6448,52915,1070,209873,5378,3416,310,,2420,0,,,539,,,C
20200507,PR,2031,63,2031,63,,0,102,3,,164,0,,,,,,D
20200507,RI,73557,2200,10910,271,62647,1929,388,18,1153,318,30,82,,56,,696,A+
20200507,SC,77482,0,6936,0,70546,0,305,0,1152,,0,,,,,3816,B
20200507,SD,20114,698,2905,126,17209,572,31,2,236,70,6,,,,,2028,C
20200507,TN,236328,9227,14096,158,222232,9069,237,-2,1266,558,45,,,,,6783,B
20200507,TX,455162,16224,35390,968,419772,15256,973,25,,1750,0,,,,,18440,B
20200507,UT,134543,3541,5724,129,128819,3412,61,3,476,194,12,,159,,73,2640,B
20200507,VA,123152,9444,21570,1314,101582,8130,769,56,4438,1613,325,371,,203,,2825,A+
20200507,VI,1056,0,66,0,990,0,4,0,,,0,,,,,54,C
20200507,VT,17606,411,916,2,16690,409,53,1,,14,0,2,,0,,718,B
20200507,WA,234367,4584,17914,196,216453,4388,870,8,,358,0,144,,,,,B
20200507,WI,103656,5568,10621,359,93035,5209,374,12,1732,624,38,108,435,,,4520,A+
20200507,WV,57521,1737,1287,39,56234,1698,51,1,,76,0,22,,12,,716,C
20200507,WY,12034,27,631,27,11403,0,7,0,59,11,-1,,,,,416,C
20200506,AK,23655,963,372,1,23283,962,10,1,,8,0,,,,,284,C
20200506,AL,109516,2750,8581,296,100935,2454,340,27,1158,,51,,442,,264,,B
20200506,AR,59003,4368,3568,72,55435,4296,85,2,453,69,0,,,14,89,2109,B
20200506,AS,83,0,0,0,83,0,0,0,,,0,,,,,,F
20200506,AZ,91737,3477,9707,402,82030,3075,426,31,2244,754,52,286,,193,,1693,A+
20200506,CA,809036,29134,58815,2603,750221,26531,2412,95,,4681,0,1415,,,,,B
20200506,CO,85976,972,17364,457,68612,515,903,52,2919,792,81,,,,,2801,B
20200506,CT,111447,2804,30995,374,80452,2430,2718,85,7758,1445,0,,,,,4346,B
20200506,DC,24984,655,5461,139,19523,516,277,13,,447,0,130,,91,,808,A+
20200506,DE,26468,1788,5778,407,20690,1381,269,3,,299,0,,,,,2008,B
20200506,FL,480051,14360,38002,563,442049,13797,1605,69,6776,,230,,,,,,C
20200506,GA,204137,3254,30696,985,173441,2269,1311,23,5765,,131,,1343,,,,A
20200506,GU,3627,137,151,2,3476,135,5,0,,,0,,,,,123,F
20200506,HI,35199,1200,625,4,34574,1196,17,0,73,,0,,,,,551,B
20200506,IA,63171,2602,10404,293,52767,2309,219,12,,414,0,151,,103,,3803,B
20200506,ID,30545,237,2127,21,28418,216,65,1,203,21,2,,84,,,1379,C
20200506,IL,361260,14974,68232,2270,293028,12704,2974,136,,4832,0,1231,,780,,,A
20200506,IN,120496,4662,21870,837,98626,3825,1377,51,,1558,0,526,,281,,,A+
20200506,KS,42114,2022,5734,276,36380,1746,144,7,571,,5,,213,,96,318,A
20200506,KY,61014,967,5822,577,55192,390,275,14,1603,347,74,189,685,,,2058,A
20200506,LA,194672,6441,30399,403,164273,6038,2115,0,,1465,0,,,187,,20316,B
20200506,MA,339639,6290,72025,1754,267614,4536,4420,208,7080,3564,249,922,,,,,A
20200506,MD,144012,3909,28163,1046,115849,2863,1520,44,5497,1707,160,584,,,,1903,A
20200506,ME,23346,2574,1254,28,22092,2546,62,1,191,37,4,18,,12,,766,B
20200506,MI,275694,12106,51131,634,224563,11472,4839,58,,1818,0,794,,617,,15659,A+
20200506,MN,104557,4479,11510,634,93047,3845,485,30,1405,443,55,180,488,,,4520,A
20200506,MO,100747,5681,9102,186,91645,5495,396,19,,953,0,,,134,,,B
20200506,MP,1798,1,15,1,1783,0,2,0,,,0,,,,,12,D
20200506,MS,80525,217,8424,217,72101,0,374,32,1392,618,40,144,,79,,4421,B
20200506,MT,19704,4432,456,0,19248,4432,16,0,62,6,0,,,,,417,C
20200506,NC,164482,12682,12758,502,151724,12180,477,25,,516,0,,,,,,B
20200506,ND,38632,2211,1323,57,37309,2154,22,5,97,32,2,,,,,582,C
20200506,NE,36128,1519,6438,355,29690,1164,82,4,,,0,,,,,,D
20200506,NH,27733,863,2636,48,25097,815,92,6,295,115,9,,82,,,1105,B
20200506,NJ,288920,1297,131890,1297,157030,0,8549,305,,5221,0,1549,,1146,,15642,A+
20200506,NM,83251,1531,4138,107,79113,1424,162,6,687,178,20,,,,,964,C
20200506,NV,49275,1391,5663,69,43612,1322,311,14,,,0,,,,,203,D
20200506,NY,1055921,27022,323978,2786,731943,24236,19877,232,81570,9179,652,3098,,,,54597,B
20200506,OH,168929,8194,21576,607,147353,7587,1225,90,4052,1045,96,407,1151,275,,,B
20200506,OK,82890,3473,4201,74,78689,3399,253,6,773,230,0,102,,,,2909,A
20200506,OR,67976,2552,2916,77,65060,2475,115,2,641,191,19,47,,20,,1125,A+
20200506,PA,256340,5458,51845,888,204495,4570,3106,94,,2545,0,,,560,,,C
20200506,PR,1968,-9269,1968,44,,-9313,99,0,,144,0,,,,,,D
20200506,RI,71357,2279,10639,342,60718,1937,370,15,1123,324,31,86,,60,,665,A+
20200506,SC,77482,9711,6936,179,70546,9532,305,22,1152,,42,,,,,3816,B
20200506,SD,19416,394,2779,58,16637,336,29,5,230,72,10,,,,,1977,C
20200506,TN,227101,8239,13938,248,213163,7991,239,13,1221,557,65,,,,,6564,B
20200506,TX,438938,11728,34422,1053,404516,10675,948,42,,1812,0,,,,,17622,B
20200506,UT,131002,4287,5595,146,125407,4141,58,2,464,,8,,,,,2509,C
20200506,VA,113708,0,20256,0,93452,0,713,0,4113,1496,0,361,,189,,2617,A+
20200506,VI,1056,17,66,0,990,17,4,0,,,0,,,,,54,C
20200506,VT,17195,221,914,5,16281,216,52,0,,26,0,2,,0,,706,B
20200506,WA,229783,5299,17718,248,212065,5051,862,21,,390,0,127,,,,,B
20200506,WI,98088,4225,10262,366,87826,3859,362,9,1694,511,31,107,423,,,4348,A+
20200506,WV,55784,961,1248,10,54536,951,50,0,,76,0,22,,12,,716,C
20200506,WY,12007,1092,604,8,11403,1084,7,0,60,11,0,,,,,409,C
20200505,AK,22692,969,371,1,22321,968,9,0,,13,0,,,,,277,C
20200505,AL,106766,3649,8285,260,98481,3389,313,17,1107,,43,,428,,255,,B
20200505,AR,54635,193,3496,38,51139,155,83,2,453,89,15,,,16,89,2041,B
20200505,AS,83,0,0,0,83,0,0,0,,,0,,,,,,F
20200505,AZ,88260,3007,9305,386,78955,2621,395,33,2192,728,57,303,,185,,1671,A+
20200505,CA,779902,32028,56212,1275,723690,30753,2317,63,,4622,0,1388,,,,,B
20200505,CO,85004,1914,16907,272,68097,1642,851,9,2838,834,39,,,,,2743,B
20200505,CT,108643,6150,30621,1334,78022,4816,2633,138,7758,1500,0,,,,,4346,B
20200505,DC,24329,534,5322,152,19007,382,264,6,,447,0,130,,91,,667,A+
20200505,DE,24680,570,5371,83,19309,487,266,11,,284,0,,,,,1847,B
20200505,FL,465691,21421,37439,542,428252,20879,1536,113,6546,,217,,,,,,C
20200505,GA,200883,17558,29711,343,171172,17215,1288,66,5634,,108,,1318,,,,A
20200505,GU,3490,99,149,0,3341,99,5,0,,,0,,,,,124,F
20200505,HI,33999,133,621,1,33378,132,17,0,73,,0,,,,,548,B
20200505,IA,60569,3408,10111,408,50458,3000,207,19,,407,0,152,,94,,3572,B
20200505,ID,30308,501,2106,45,28202,456,64,0,201,27,1,,83,,,1358,C
20200505,IL,346286,13139,65962,2122,280324,11017,2838,176,,4780,0,1266,,780,,,A
20200505,IN,115834,2537,21033,526,94801,2011,1326,62,,1537,0,480,,272,,,A+
20200505,KS,40092,1489,5458,213,34634,1276,137,1,566,,13,,212,,95,296,A
20200505,KY,60047,1638,5245,115,54802,1523,261,8,1529,333,10,174,659,,,1892,A
20200505,LA,188231,7300,29996,323,158235,6977,2115,51,,1512,0,,,194,,20316,B
20200505,MA,333349,9081,70271,1184,263078,7897,4212,122,6831,3542,209,914,,,,,A
20200505,MD,140103,3108,27117,709,112986,2399,1476,52,5337,1693,138,573,,,,1810,A
20200505,ME,20772,21,1226,21,19546,0,61,4,187,36,1,18,,12,,741,B
20200505,MI,263588,11108,50497,688,213091,10420,4781,59,,1948,0,839,,670,,15659,A+
20200505,MN,100078,3166,10876,641,89202,2525,455,27,1350,434,79,182,475,,,4159,A
20200505,MO,95066,3615,8916,162,86150,3453,377,19,,893,0,,,139,,,A
20200505,MP,1797,462,14,0,1783,462,2,0,,,0,,,,,12,D
20200505,MS,80308,631,8207,330,72101,301,342,32,1352,645,36,162,,77,,4421,B
20200505,MT,15272,184,456,-1,14816,185,16,0,62,6,0,,,,,410,C
20200505,NC,151800,5361,12256,408,139544,4953,452,22,,534,0,,,,,,B
20200505,ND,36421,1667,1266,41,35155,1626,17,2,95,31,1,,,,,559,C
20200505,NE,34609,855,6083,173,28526,682,78,0,,,0,,,,,,D
20200505,NH,26870,0,2588,0,24282,0,86,0,286,111,0,,82,,,1019,C
20200505,NJ,287623,10403,130593,2324,157030,8079,8244,334,,5328,0,1534,,1169,,15642,A+
20200505,NM,81720,3743,4031,181,77689,3562,156,5,667,181,80,,,,,842,C
20200505,NV,47884,1718,5594,103,42290,1615,297,5,,,0,,,,,200,D
20200505,NY,1028899,21589,321192,2239,707707,19350,19645,230,80918,9600,542,3281,,,,58950,B
20200505,OH,160735,5580,20969,495,139766,5085,1135,79,3956,1069,147,402,1123,281,,,B
20200505,OK,79417,15569,4127,83,75290,15486,247,9,773,236,20,113,,,,2830,A
20200505,OR,65424,1967,2839,80,62585,1887,113,4,622,219,14,49,,25,,860,A+
20200505,PA,250882,5292,50957,865,199925,4427,3012,554,,2580,0,,,550,,,B
20200505,PR,11237,81,1924,81,9313,0,99,2,,140,0,,,,,,D
20200505,RI,69078,2282,10297,303,58781,1979,355,14,1092,327,31,89,,62,,639,A+
20200505,SC,67771,3583,6757,131,61014,3452,283,8,1110,,0,,,,,3622,B
20200505,SD,19022,309,2721,53,16301,256,24,3,220,75,9,,,,,1895,C
20200505,TN,218862,7419,13690,119,205172,7300,226,7,1156,520,13,,,,,6356,B
20200505,TX,427210,19812,33369,1037,393841,18775,906,22,,1888,0,,,,,16791,B
20200505,UT,126715,2054,5449,132,121266,1922,56,6,456,,15,,,,,2387,C
20200505,VA,113708,1415,20256,764,93452,651,713,29,4113,1496,103,361,,189,,2617,A+
20200505,VI,1039,8,66,0,973,8,4,0,,,0,,,,,51,C
20200505,VT,16974,179,909,3,16065,176,52,0,,33,0,2,,0,,,B
20200505,WA,224484,5069,17470,261,207014,4808,841,7,,292,0,102,,,,,B
20200505,WI,93863,3858,9896,358,83967,3500,353,13,1663,543,42,92,414,,,4131,A
20200505,WV,54823,1584,1238,32,53585,1552,50,0,,64,0,23,,12,,630,C
20200505,WY,10915,461,596,10,10319,451,7,0,60,13,0,,,,,405,C
20200504,AK,21723,145,370,2,21353,143,9,0,,12,0,,,,,263,C
20200504,AL,103117,10617,8025,300,95092,10317,296,6,1064,,29,,411,,247,,B
20200504,AR,54442,1552,3458,27,50984,1525,81,5,438,91,11,,,16,88,2016,B
20200504,AS,83,26,0,0,83,26,0,0,,,0,,,,,,F
20200504,AZ,85253,4134,8919,279,76334,3855,362,0,2135,703,46,288,,200,,1632,A+
20200504,CA,747874,32123,54937,1321,692937,30802,2254,39,,4616,0,1464,,,,,B
20200504,CO,83090,3184,16635,410,66455,2774,842,10,2799,883,6,,,,,2650,B
20200504,CT,102493,0,29287,0,73206,0,2495,59,7758,1488,0,,,,,4346,B
20200504,DC,23795,693,5170,154,18625,539,258,7,,447,0,130,,91,,666,A+
20200504,DE,24110,373,5288,80,18822,293,255,9,,281,0,,,,,1716,B
20200504,FL,444270,16081,36897,819,407373,15262,1423,20,6329,,85,,,,,,C
20200504,GA,183325,8229,29368,766,153957,7463,1222,45,5526,,133,,1284,,,,A
20200504,GU,3391,89,149,-1,3242,90,5,0,,,0,,,,,125,F
20200504,HI,33866,916,620,0,33246,916,17,1,73,,1,,,,,544,B
20200504,IA,57161,3975,9703,534,47458,3441,188,4,,389,0,143,,93,,3486,B
20200504,ID,29807,0,2061,0,27746,0,64,1,200,27,0,,83,,,1267,C
20200504,IL,333147,13834,63840,2341,269307,11493,2662,44,,4493,0,1232,,763,,,A
20200504,IN,113297,4438,20507,574,92790,3864,1264,18,,1449,0,483,,249,,,A+
20200504,KS,38603,1825,5245,215,33358,1610,136,2,553,,6,,209,,95,291,A
20200504,KY,58409,760,5130,251,53279,509,253,5,1519,329,108,170,654,,,1892,A
20200504,LA,180931,4771,29673,333,151258,4438,2064,95,,1502,0,,,220,,20316,B
20200504,MA,324268,9622,69087,1000,255181,8622,4090,86,6622,3539,115,908,,,,,A
20200504,MD,136995,4201,26408,946,110587,3255,1424,52,5199,1649,148,563,,,,1695,A
20200504,ME,20751,20,1205,20,19546,0,57,0,186,37,3,18,,11,,720,B
20200504,MI,252480,8090,49809,780,202671,7310,4722,81,,1948,0,839,,670,,15659,A+
20200504,MN,96912,4068,10235,824,86677,3244,428,9,1271,396,72,166,444,,,3784,A
20200504,MO,91451,8475,8754,368,82697,8107,358,6,,858,0,,,135,,,A
20200504,MP,1335,0,14,0,1321,0,2,0,,,0,,,,,12,D
20200504,MS,79677,2084,7877,327,71800,1757,310,7,1316,646,18,145,,78,,4421,B
20200504,MT,15088,81,457,2,14631,79,16,0,62,6,1,,,,,404,C
20200504,NC,146439,2604,11848,184,134591,2420,430,8,,498,0,,,,,,B
20200504,ND,34754,1401,1225,34,33529,1367,15,-1,94,31,4,,,,,540,C
20200504,NE,33754,2492,5910,584,27844,1908,78,2,,,0,,,,,,D
20200504,NH,26870,-1523,2588,159,24282,-1682,86,2,286,103,9,,,,,1017,C
20200504,NJ,277220,2154,128269,1525,148951,629,7910,39,,5287,0,1610,,1189,,15642,A+
20200504,NM,77977,3033,3850,118,74127,2915,151,12,587,164,0,,,,,832,C
20200504,NV,46166,897,5491,65,40675,832,292,5,,,0,,,,,185,D
20200504,NY,1007310,21399,318953,2538,688357,18861,19415,226,80376,9647,608,3330,,,,58950,B
20200504,OH,155155,4989,20474,560,134681,4429,1056,18,3809,1078,40,412,1090,275,,,B
20200504,OK,63848,72,4044,72,59804,0,238,0,753,236,10,92,,,,2682,A
20200504,OR,63457,1403,2759,79,60698,1324,109,0,608,207,10,41,,17,,860,A+
20200504,PA,245590,4949,50092,825,195498,4124,2458,14,,2708,0,,,573,,,B
20200504,PR,11156,35,1843,35,9313,0,97,0,,152,0,,,,,,D
20200504,RI,66796,1860,9994,291,56802,1569,341,21,1061,339,48,84,,61,,601,A+
20200504,SC,64188,0,6626,0,57562,0,275,0,1110,,0,,,,,3622,B
20200504,SD,18713,296,2668,37,16045,259,21,0,211,69,14,,,,,1830,C
20200504,TN,211443,6836,13571,394,197872,6442,219,9,1143,499,8,,,,,6081,B
20200504,TX,407398,16838,32332,784,375066,16054,884,17,,1533,0,,,,,16090,B
20200504,UT,124661,2559,5317,142,119344,2417,50,0,441,,5,,,,,2342,C
20200504,VA,112293,4291,19492,821,92801,3470,684,24,4010,1463,100,348,,192,,2547,A+
20200504,VI,1031,14,66,0,965,14,4,0,,,0,,,,,51,C
20200504,VT,16795,324,906,5,15889,319,52,0,,15,0,,,,,,C
20200504,WA,219415,5510,17209,266,202206,5244,834,4,,263,0,86,,,,,B
20200504,WI,90005,2781,9538,311,80467,2470,340,1,1621,573,13,116,404,,,3973,A
20200504,WV,53239,1601,1206,15,52033,1586,50,0,,73,0,28,,15,,611,C
20200504,WY,10454,235,586,7,9868,228,7,0,60,13,0,,,,,391,C
20200503,AK,21578,179,368,3,21210,176,9,0,,12,0,,,,,262,C
20200503,AL,92500,291,7725,291,84775,0,290,2,1035,,12,,403,,242,,B
20200503,AR,52890,1308,3431,59,49459,1249,76,3,427,100,13,,,20,88,1999,B
20200503,AS,57,0,0,0,57,0,0,0,,,0,,,,,,F
20200503,AZ,81119,3122,8640,276,72479,2846,362,14,2089,732,56,282,,192,,1597,A+
20200503,CA,715751,28948,53616,1419,662135,27529,2215,44,,4734,0,1468,,,,,B
20200503,CO,79906,2957,16225,457,63681,2500,832,12,2793,883,46,,,,,2607,B
20200503,CT,102493,2236,29287,523,73206,1713,2436,97,7758,1551,0,,,,,4346,B
20200503,DC,23102,1098,5016,219,18086,879,251,11,,,0,,,,,666,B
20200503,DE,23737,625,5208,170,18529,455,246,11,,284,0,,,,,1640,B
20200503,FL,428189,12177,36078,615,392111,11562,1403,15,6244,,299,,,,,,C
20200503,GA,175096,296,28602,296,146494,0,1177,3,5393,,6,,1249,,,,A
20200503,GU,3302,114,150,2,3152,112,5,0,,,0,,,,,126,F
20200503,HI,32950,965,620,1,32330,964,16,0,72,,0,,,,,541,B
20200503,IA,53186,6837,9169,528,44017,6309,184,9,,378,0,133,,93,,3325,B
20200503,ID,29807,317,2061,26,27746,291,63,0,200,27,22,,83,,,1267,C
20200503,IL,319313,19417,61499,2994,257814,16423,2618,59,,4701,0,1232,,759,,,A
20200503,IN,108859,4718,19933,638,88926,4080,1246,17,,1398,0,476,,242,,,A+
20200503,KS,36778,1836,5030,284,31748,1552,134,3,547,,6,,209,,95,286,A
20200503,KY,57649,0,4879,0,52770,0,248,0,1411,334,0,178,652,,,1752,A
20200503,LA,176160,3302,29340,200,146820,3102,1969,19,,1530,0,,,213,,17303,B
20200503,MA,314646,15652,68087,1824,246559,13828,4004,158,6507,3617,129,904,,,,,A
20200503,MD,132794,7272,25462,989,107332,6283,1372,49,5051,1635,141,565,,,,1666,A
20200503,ME,20731,33,1185,33,19546,0,57,1,183,33,2,18,,12,,706,B
20200503,MI,244390,7005,49029,357,195361,6648,4641,62,,2100,0,850,,713,,15659,A+
20200503,MN,92844,3164,9411,340,83433,2824,419,24,1199,373,40,155,426,,,2596,A
20200503,MO,82976,232,8386,232,74590,0,352,1,,896,0,,,141,,,A
20200503,MP,1335,387,14,0,1321,387,2,0,,,0,,,,,12,D
20200503,MS,77593,3118,7550,109,70043,3009,303,12,1298,667,33,143,,73,,3413,B
20200503,MT,15007,372,455,0,14552,372,16,0,61,5,0,,,,,404,C
20200503,NC,143835,4360,11664,155,132171,4205,422,2,,475,0,,,,,,B
20200503,ND,33353,1806,1191,38,32162,1768,16,-8,90,31,0,,,,,517,C
20200503,NE,31262,1914,5326,488,25936,1426,76,3,,,0,,,,,,D
20200503,NH,28393,4044,2429,119,25964,3925,84,3,277,103,7,,,,,1107,C
20200503,NJ,275066,12754,126744,3027,148322,9727,7871,129,,5317,0,1623,,1198,,15642,A+
20200503,NM,74944,3826,3732,219,71212,3607,139,8,587,168,0,,,,,812,C
20200503,NV,45269,882,5426,115,39843,767,287,6,,,0,,,,,182,D
20200503,NY,985911,26840,316415,3438,669496,23402,19189,280,79768,9786,826,3430,,,,58950,B
20200503,OH,150166,4347,19914,579,130252,3768,1038,17,3769,931,57,393,1078,255,,,B
20200503,OK,63776,121,3972,121,59804,0,238,0,743,236,0,92,,,,2635,A
20200503,OR,62054,1918,2680,45,59374,1873,109,0,598,205,3,46,,21,,860,A+
20200503,PA,240641,5265,49267,962,191374,4303,2444,26,,2645,0,,,562,,,B
20200503,PR,11121,51,1808,51,9313,0,97,2,,171,0,,,,,,D
20200503,RI,64936,1791,9703,181,55233,1610,320,24,1013,330,36,83,,59,,565,A+
20200503,SC,64188,2572,6626,137,57562,2435,275,8,1110,,0,,,,,3622,B
20200503,SD,18417,326,2631,43,15786,283,21,0,197,71,10,,,,,1799,C
20200503,TN,204607,8331,13177,516,191430,7815,210,1,1135,510,10,,,,,5814,B
20200503,TX,390560,9912,31548,1026,359012,8886,867,20,,1540,0,,,,,15544,B
20200503,UT,122102,4298,5175,194,116927,4104,50,1,436,,18,,,,,2238,C
20200503,VA,108002,5906,18671,940,89331,4966,660,44,3910,1413,172,385,,193,,2497,B
20200503,VI,1017,29,66,0,951,29,4,0,,,0,,,,,51,C
20200503,VT,16471,343,901,5,15570,338,52,1,,19,0,,,,,,C
20200503,WA,213905,1484,16943,141,196962,1343,830,6,,411,0,120,,,,,B
20200503,WI,87224,2734,9227,307,77997,2427,339,5,1608,582,17,118,402,,,3723,A+
20200503,WV,51638,2492,1191,22,50447,2470,50,2,,73,0,28,,15,,611,C
20200503,WY,10219,190,579,13,9640,177,7,0,60,13,2,,,,,391,C
20200502,AK,21399,1074,365,1,21034,1073,9,0,,10,0,,,,,261,C
20200502,AL,92209,276,7434,276,84775,0,288,9,1023,,15,,335,,195,,B
20200502,AR,51582,1906,3372,51,48210,1855,73,9,414,95,0,,,20,85,1987,B
20200502,AS,57,0,0,0,57,0,0,0,,,0,,,,,,F
20200502,AZ,77997,3118,8364,402,69633,2716,348,18,2033,718,47,291,,198,,1565,A+
20200502,CA,686803,31818,52197,1755,634606,30063,2171,98,,4722,0,1433,,,,,B
20200502,CO,76949,4559,15768,484,61181,4075,820,43,2747,931,50,,,,,2553,B
20200502,CT,100257,0,28764,0,71493,0,2339,0,7758,1592,0,,,,,4346,B
20200502,DC,22004,869,4797,139,17207,730,240,9,,,0,,,,,666,B
20200502,DE,23112,527,5038,120,18074,407,235,13,,300,0,,,,,1546,B
20200502,FL,416012,13313,35463,735,380549,12578,1388,74,5945,,150,,,,,,C
20200502,GA,174800,6433,28306,1036,146494,5397,1174,20,5387,,118,,1247,,,,A
20200502,GU,3188,183,148,2,3040,181,5,0,,,0,,,,,131,F
20200502,HI,31985,891,619,1,31366,890,16,0,72,,2,,,,,532,B
20200502,IA,46349,757,8641,757,37708,0,175,5,,353,0,131,,90,,3156,A
20200502,ID,29490,265,2035,20,27455,245,63,0,178,23,0,,76,,,1215,C
20200502,IL,299896,15208,58505,2450,241391,12758,2559,102,,4717,0,1250,,789,,,A
20200502,IN,104141,4502,19295,665,84846,3837,1229,54,,1456,0,487,,244,,,A+
20200502,KS,34942,1908,4746,297,30196,1611,131,1,541,,7,,206,,95,286,A
20200502,KY,57649,1037,4879,171,52770,866,248,8,1411,334,36,178,652,,,1752,A
20200502,LA,172858,4607,29140,429,143718,4178,1950,23,,1545,0,,,208,,17303,B
20200502,MA,298994,9358,66263,1952,232731,7406,3846,130,6378,3601,209,921,,,,,A
20200502,MD,125522,4539,24473,1001,101049,3538,1323,47,4910,1657,192,566,,,,1590,A
20200502,ME,20698,29,1152,29,19546,0,56,1,181,36,4,19,,10,,689,B
20200502,MI,237385,10338,48672,432,188713,9906,4579,59,,2100,0,850,,713,,15659,A+
20200502,MN,89680,3730,9071,335,80609,3395,395,24,1159,389,63,135,404,,,2002,A
20200502,MO,82744,319,8154,319,74590,0,351,14,,896,0,,,141,,,A
20200502,MP,948,185,14,0,934,185,2,0,,,0,,,,,12,D
20200502,MS,74475,2927,7441,229,67034,2698,291,10,1265,632,39,142,,71,,3413,B
20200502,MT,14635,432,455,2,14180,430,16,0,61,5,0,,,,,404,C
20200502,NC,139475,5643,11509,586,127966,5057,420,21,,502,0,,,,,,B
20200502,ND,31547,2022,1153,46,30394,1976,24,1,90,32,4,,,,,510,C
20200502,NE,29348,1963,4838,557,24510,1406,73,3,,,0,,,,,,D
20200502,NH,24349,2300,2310,164,22039,2136,81,9,270,103,8,,,,,980,C
20200502,NJ,262312,5767,123717,2527,138595,3240,7742,204,,5713,0,1715,,1230,,15642,A+
20200502,NM,71118,3249,3513,102,67605,3147,131,8,587,159,51,,,,,785,C
20200502,NV,44387,792,5311,84,39076,708,281,4,,,0,,,,,182,D
20200502,NY,959071,31633,312977,4663,646094,26970,18909,299,78942,10350,718,3501,,,,57540,B
20200502,OH,145819,5313,19335,592,126484,4721,1021,19,3712,1003,78,424,1066,267,,,B
20200502,OK,63655,103,3851,103,59804,0,238,8,743,236,28,92,,,,2554,A
20200502,OR,60136,1960,2635,56,57501,1904,109,5,595,209,4,50,,22,,,A
20200502,PA,235376,7928,48305,1334,187071,6594,2418,64,,2673,0,,,571,,,B
20200502,PR,11070,182,1757,182,9313,0,95,3,,187,0,,,,,,D
20200502,RI,63145,1484,9522,189,53623,1295,296,17,977,333,40,80,,54,,531,A+
20200502,SC,61616,2237,6489,231,55127,2006,267,11,1110,,0,,,,,3622,B
20200502,SD,18091,728,2588,63,15503,665,21,0,187,71,8,,,,,1759,C
20200502,TN,196276,10144,12661,770,183615,9374,209,5,1125,474,12,,,,,5718,B
20200502,TX,380648,28873,30522,1293,350126,27580,847,31,,1725,0,,,,,14891,B
20200502,UT,117804,5246,4981,153,112823,5093,49,3,418,,15,,,,,2185,C
20200502,VA,102096,-4344,17731,830,84365,-5174,616,35,3738,1426,84,375,,202,,2312,B
20200502,VI,988,111,66,0,922,111,4,0,,,0,,,,,51,C
20200502,VT,16128,313,896,11,15232,302,51,1,,11,0,,,,,,C
20200502,WA,212421,2319,16802,149,195619,2170,824,10,,428,0,117,,,,,B
20200502,WI,84490,3374,8920,370,75570,3004,334,7,1591,582,47,118,400,,,3698,A+
20200502,WV,49146,2302,1169,33,47977,2269,48,2,,76,0,29,,15,,572,C
20200502,WY,10029,334,566,7,9463,327,7,0,58,13,2,,,,,387,C
20200501,AK,20325,1206,364,9,19961,1197,9,0,,25,0,,,,,254,C
20200501,AL,91933,4737,7158,139,84775,4598,279,10,1008,,30,,335,,195,,B
20200501,AR,49676,1297,3321,66,46355,1231,64,3,414,95,12,,,23,85,1973,B
20200501,AS,57,54,0,0,57,54,0,0,,,0,,,,,,F
20200501,AZ,74879,3093,7962,314,66917,2779,330,10,1986,709,49,311,,187,,1528,A+
20200501,CA,654985,29648,50442,1525,604543,28123,2073,91,,4706,0,1434,,,,,B
20200501,CO,72390,1331,15284,526,57106,805,777,11,2697,959,76,,,,,2486,B
20200501,CT,100257,3124,28764,1064,71493,2060,2339,82,7758,1592,7758,,,,,4346,B
20200501,DC,21135,1056,4658,335,16477,721,231,7,,,0,,,,,666,B
20200501,DE,22585,765,4918,184,17667,581,222,12,,281,0,,,,,1403,B
20200501,FL,402699,20294,34728,1038,367971,19256,1314,24,5795,,0,,,,,,C
20200501,GA,168367,19323,27270,1115,141097,18208,1154,34,5269,,113,,1215,,,,A
20200501,GU,3005,897,146,0,2859,897,5,0,,,0,,,,,131,F
20200501,HI,31094,454,618,5,30476,449,16,0,70,,1,,,,,526,B
20200501,IA,45592,2925,7884,739,37708,2186,170,8,,345,0,121,,91,,2899,A
20200501,ID,29225,379,2015,31,27210,348,63,3,178,28,3,,75,,,1175,C
20200501,IL,284688,14821,56055,3137,228633,11684,2457,102,,4900,0,1263,,777,,,A
20200501,IN,99639,4641,18630,795,81009,3846,1175,61,,1431,0,514,,257,,,A+
20200501,KS,33034,1408,4449,211,28585,1197,130,1,534,,11,,206,,96,280,A
20200501,KY,56612,2511,4708,169,51904,2342,240,5,1375,330,16,178,642,,,1675,A
20200501,LA,168251,6942,28711,710,139540,6232,1927,65,,1607,0,,,230,,17303,B
20200501,MA,289636,13989,64311,2106,225325,11883,3716,154,6169,3716,227,947,,,,,A
20200501,MD,120983,6624,23472,1730,97511,4894,1276,50,4718,1668,159,568,,,,1517,A
20200501,ME,20669,28,1123,28,19546,0,55,2,177,37,7,17,,9,,657,B
20200501,MI,227047,10598,48240,735,178807,9863,4520,86,,2319,0,966,,760,,8342,A+
20200501,MN,85950,4485,8736,620,77214,3865,371,28,1096,369,52,118,380,,,1911,A
20200501,MO,82425,1738,7835,273,74590,1465,337,8,,883,0,,,137,,,A
20200501,MP,763,164,14,0,749,164,2,0,,,0,,,,,12,D
20200501,MS,71548,5208,7212,397,64336,4811,281,20,1226,651,51,160,,75,,3413,B
20200501,MT,14203,289,453,0,13750,289,16,0,61,5,0,,,,,397,C
20200501,NC,133832,5796,10923,414,122909,5382,399,21,,547,0,,,,,,B
20200501,ND,29525,2065,1107,40,28418,2025,23,4,86,27,1,,,,,482,C
20200501,NE,27385,2064,4281,497,23104,1567,70,2,,,0,,,,,,D
20200501,NH,22049,128,2146,92,19903,36,72,6,262,112,3,,,,,980,C
20200501,NJ,256545,8627,121190,2538,135355,6089,7538,310,,5972,0,1724,,1286,,15642,A+
20200501,NM,67869,2784,3411,198,64458,2586,123,11,536,172,0,,,,,760,C
20200501,NV,43595,1609,5227,229,38368,1380,277,8,,,0,,,,,182,D
20200501,NY,927438,26802,308314,3942,619124,22860,18610,289,78224,10993,824,3640,,,,56187,B
20200501,OH,140506,6616,18743,716,121763,5900,1002,27,3634,,101,,1056,,,,B
20200501,OK,63552,130,3748,130,59804,0,230,8,715,255,12,113,,,,2467,A
20200501,OR,58176,2144,2579,69,55597,2075,104,1,591,208,13,49,,23,,,A
20200501,PA,227448,6083,46971,1208,180477,4875,2354,62,,2683,0,,,590,,,B
20200501,PR,10888,36,1575,36,9313,0,92,0,,200,0,,,,,,D
20200501,RI,61661,2545,9333,317,52328,2228,279,13,937,352,41,76,,51,,485,A+
20200501,SC,59379,2867,6258,163,53121,2704,256,12,1110,,110,,,,,3622,B
20200501,SD,17363,335,2525,76,14838,259,21,4,179,69,6,,,,,1686,C
20200501,TN,186132,8506,11891,1156,174241,7350,204,5,1113,529,68,,,,,5546,B
20200501,TX,351775,21475,29229,1142,322546,20333,816,34,,1778,0,,,,,14122,B
20200501,UT,112558,4057,4828,156,107730,3901,46,0,403,,13,,,,,2062,C
20200501,VA,106440,14931,16901,1055,89539,13876,581,29,3654,1431,0,366,,193,,2196,B
20200501,VI,877,4,66,0,811,4,4,0,,,0,,,,,51,C
20200501,VT,15815,579,885,6,14930,573,50,1,,19,0,,,,,,C
20200501,WA,210102,4792,16653,344,193449,4448,814,13,,470,0,120,,,,,B
20200501,WI,81116,3670,8550,498,72566,3172,327,11,1544,560,32,127,391,,,3352,A+
20200501,WV,46844,2303,1136,18,45708,2285,46,5,,81,0,33,,18,,555,C
20200501,WY,9695,249,559,15,9136,234,7,0,56,13,0,,,,,373,C
20200430,AK,19119,0,355,0,18764,0,9,0,,19,0,,,,,252,C
20200430,AL,87196,6747,7019,177,80177,6570,269,24,978,,33,,335,,195,,B
20200430,AR,48379,2930,3255,63,45124,2867,61,2,402,95,13,,,23,85,1305,B
20200430,AS,3,0,0,0,3,0,0,0,,,0,,,,,,F
20200430,AZ,71786,2973,7648,446,64138,2527,320,16,1937,755,53,311,,194,,1499,A+
20200430,CA,625337,22198,48917,2417,576420,19781,1982,95,,4981,0,1473,,,,,B
20200430,CO,71059,1610,14758,23,56301,1587,766,6,2621,966,11,,,,,2415,B
20200430,CT,97133,2315,27700,933,69433,1382,2257,89,,1650,0,,,,,,C
20200430,DC,20079,850,4323,217,15756,633,224,19,,,0,,,,,660,B
20200430,DE,21820,282,4734,79,17086,203,210,6,,296,0,,,,,1275,B
20200430,FL,382405,8917,33690,497,348715,8420,1290,50,5795,,171,,,,,,C
20200430,GA,149044,5105,26155,583,122889,4522,1120,27,5156,,100,,1171,,,,A
20200430,GU,2108,261,146,1,1962,260,5,0,,,0,,,,,131,F
20200430,HI,30640,1022,613,4,30027,1018,16,0,69,,0,,,,,516,B
20200430,IA,42667,1330,7145,302,35522,1028,162,14,,335,0,121,,86,,2697,B
20200430,ID,28846,464,1984,32,26862,432,60,0,175,36,2,,74,,,1121,C
20200430,IL,269867,13200,52918,2563,216949,10637,2355,140,,4953,0,1289,,785,,,A
20200430,IN,94998,3448,17835,653,77163,2795,1114,49,,1466,0,549,,275,,,A+
20200430,KS,31626,2168,4238,500,27388,1668,129,4,523,,8,,201,,93,272,A
20200430,KY,54101,1690,4539,164,49562,1526,235,10,1359,325,28,176,636,,,1668,A
20200430,LA,161309,4741,28001,341,133308,4400,1862,60,,1601,0,,,231,,17303,B
20200430,MA,275647,10029,62205,1940,213442,8089,3562,157,5942,3803,184,1001,,,,,A
20200430,MD,114359,3430,21742,893,92617,2537,1226,58,4559,1711,157,590,,,,1432,A
20200430,ME,20641,39,1095,39,19546,0,53,1,170,35,4,18,,8,,631,B
20200430,MI,216449,11588,47505,1017,168944,10571,4434,99,,2319,0,966,,760,,8342,A+
20200430,MN,81465,4347,8116,648,73349,3699,343,24,1044,365,94,130,358,,,1829,A
20200430,MO,80687,3528,7562,137,73125,3391,329,11,,853,0,,,141,,,A
20200430,MP,599,375,14,0,585,375,2,0,,,0,,,,,12,D
20200430,MS,66340,246,6815,246,59525,0,261,11,1175,639,49,146,,72,,3413,B
20200430,MT,13914,386,453,2,13461,384,16,0,61,5,0,,,,,392,C
20200430,NC,128036,9596,10509,561,117527,9035,378,24,,546,0,,,,,,B
20200430,ND,27460,1924,1067,34,26393,1890,19,0,85,30,3,,,,,458,C
20200430,NE,25321,1690,3784,410,21537,1280,68,13,,,0,,,,,,D
20200430,NH,21921,1175,2054,44,19867,1131,66,6,259,107,10,,,,,980,C
20200430,NJ,247918,6600,118652,2388,129266,4212,7228,458,,6137,0,1765,,1271,,15642,A+
20200430,NM,65085,3340,3213,239,61872,3101,112,2,536,163,27,,,,,734,C
20200430,NV,41986,958,4998,100,36988,858,269,12,,,0,,,,,158,D
20200430,NY,900636,28155,304372,4681,596264,23474,18321,306,77400,11598,950,3769,,,,54771,B
20200430,OH,133890,4982,18027,724,115863,4258,975,38,3533,,112,,1035,,,,B
20200430,OK,63422,2155,3618,145,59804,2010,222,8,703,291,10,127,,,,2401,A
20200430,OR,56032,1560,2510,64,53522,1496,103,2,578,243,9,65,,28,,,A
20200430,PA,221365,6482,45763,1397,175602,5085,2292,97,,2707,0,,,556,,,B
20200430,PR,10852,106,1539,106,9313,0,92,6,,201,0,,,,,,D
20200430,RI,59116,2305,9016,348,50100,1957,266,15,896,339,146,85,,54,,461,A+
20200430,SC,56512,2295,6095,214,50417,2081,244,41,1000,,0,,,,,3252,B
20200430,SD,17028,195,2449,76,14579,119,17,4,173,76,8,,,,,1573,C
20200430,TN,177626,9077,10735,369,166891,8708,199,4,1045,605,32,,,,,5338,B
20200430,TX,330300,15510,28087,1033,302213,14477,782,50,,1686,0,,,,,13353,B
20200430,UT,108501,2723,4672,177,103829,2546,46,1,390,,7,,,,,1939,C
20200430,VA,91509,5569,15846,885,75663,4684,552,30,3654,1550,46,372,,208,,2104,B
20200430,VI,873,79,66,4,807,75,4,0,,,0,,,,,51,C
20200430,VT,15236,215,879,13,14357,202,49,2,,23,0,,,,,,C
20200430,WA,205310,4882,16309,267,189001,4615,801,15,,474,0,145,,,,,B
20200430,WI,77446,3156,8052,392,69394,2764,316,8,1512,554,23,119,382,,,3352,A+
20200430,WV,44541,1470,1118,23,43423,1447,41,3,,84,0,38,,20,,545,C
20200430,WY,9446,229,544,8,8902,221,7,0,56,13,0,,,,,371,C
20200429,AK,19119,2030,355,4,18764,2026,9,0,,14,0,,,,,240,B
20200429,AL,80449,4622,6842,155,73607,4467,245,3,945,,34,,335,,195,,B
20200429,AR,45449,4778,3192,81,42257,4697,59,7,389,93,389,,,18,82,1249,B
20200429,AS,3,0,0,0,3,0,0,0,,,0,,,,,,F
20200429,AZ,68813,1375,7202,254,61611,1121,304,11,1884,756,60,312,,191,,1475,A+
20200429,CA,603139,25531,46500,1469,556639,24062,1887,78,,5011,0,1512,,,,,B
20200429,CO,69449,3108,14735,856,54714,2252,760,54,2610,964,125,,,,,2275,B
20200429,CT,94818,2073,26767,455,68051,1618,2168,79,,1691,0,,,,,,C
20200429,DC,19229,344,4106,112,15123,232,205,15,,,0,,,,,660,B
20200429,DE,21538,358,4655,80,16883,278,204,12,,326,0,,,,,1173,B
20200429,FL,373488,6613,33193,347,340295,6266,1240,86,5624,,358,,,,,,C
20200429,GA,143939,3919,25572,957,118367,2962,1093,67,5056,,242,,1148,,,,A
20200429,GU,1847,164,145,0,1702,164,5,0,,,0,,,,,130,D
20200429,HI,29618,435,609,2,29009,433,16,0,69,,1,,,,,505,B
20200429,IA,41337,1514,6843,467,34494,1047,148,12,,323,0,100,,74,,2428,B
20200429,ID,28382,8330,1952,35,26430,8295,60,2,173,39,1,,73,,,1087,C
20200429,IL,256667,14478,50355,2253,206312,12225,2215,90,,5036,0,1290,,777,,,A
20200429,IN,91550,4369,17182,594,74368,3775,1065,164,,1484,0,570,,262,,,A
20200429,KS,29458,1368,3738,247,25720,1121,125,1,515,,11,,198,,88,266,A
20200429,KY,52411,3612,4375,229,48036,3383,225,12,1331,320,50,170,625,,,1617,A
20200429,LA,156568,5460,27660,374,128908,5086,1802,44,,1629,0,,,244,,17303,B
20200429,MA,265618,11118,60265,1963,205353,9155,3405,252,5758,3856,243,1011,,,,,A
20200429,MD,110929,3144,20849,736,90080,2408,1168,69,4402,1610,134,586,,,,1361,A
20200429,ME,20602,2778,1056,16,19546,2762,52,1,166,32,3,17,,7,,615,B
20200429,MI,204861,10413,46488,950,158373,9463,4335,88,,2498,0,997,,778,,8342,A+
20200429,MN,77118,7082,7468,680,69650,6402,319,18,950,320,38,119,337,,,1724,A
20200429,MO,77159,3656,7425,122,69734,3534,318,4,,891,0,,,125,,,A
20200429,MP,224,159,14,0,210,159,2,0,,,0,,,,,12,D
20200429,MS,66094,1682,6569,227,59525,1455,250,11,1126,677,38,151,,69,,3413,B
20200429,MT,13528,337,451,0,13077,337,16,1,61,5,0,,,,,382,C
20200429,NC,118440,5688,9948,380,108492,5308,354,12,,551,0,,,,,,B
20200429,ND,25536,1813,1033,42,24503,1771,19,0,82,28,3,,,,,437,C
20200429,NE,23631,26,3374,16,20257,10,55,0,,,0,,,,,,D
20200429,NH,20746,601,2010,72,18736,529,60,0,249,106,3,,,,,936,C
20200429,NJ,241318,6959,116264,2408,125054,4551,6770,328,,6289,0,1811,,1327,,15642,A+
20200429,NM,61745,2942,2974,151,58771,2791,110,6,509,157,28,,,,,705,C
20200429,NV,41028,909,4898,93,36130,816,257,6,,,0,,,,,100,D
20200429,NY,872481,27487,299691,4585,572790,22902,18015,377,76450,12159,1088,3923,,,,53238,B
20200429,OH,128908,5561,17303,534,111605,5027,937,138,3421,,81,,1014,,,,B
20200429,OK,61267,1568,3473,63,57794,1505,214,7,693,283,37,126,,,,2319,A
20200429,OR,54472,3274,2446,92,52026,3182,101,9,569,227,15,56,,24,,,A
20200429,PA,214883,5795,44366,1102,170517,4693,2195,479,,2781,0,,,602,,,B
20200429,PR,10746,33,1433,33,9313,0,86,0,,125,0,,,,,,D
20200429,RI,56811,2826,8668,372,48143,2454,251,12,750,269,18,80,,55,,391,A+
20200429,SC,54217,2072,5881,268,48336,1804,203,26,1000,,56,,,,,3252,B
20200429,SD,16833,221,2373,60,14460,161,13,2,165,69,8,,,,,1492,C
20200429,TN,168549,6621,10366,314,158183,6307,195,7,1013,614,119,,,,,5140,B
20200429,TX,314790,14406,27054,883,287736,13523,732,42,,1702,0,,,,,12507,B
20200429,UT,105778,3339,4495,152,101283,3187,45,0,383,,13,,,,,1790,C
20200429,VA,85940,2642,14961,622,70979,2020,522,30,3608,1566,186,387,,222,,2042,B
20200429,VI,794,16,62,3,732,13,4,0,,,0,,,,,51,C
20200429,VT,15021,212,866,4,14155,208,47,0,,26,0,,,,,,C
20200429,WA,200428,4923,16042,244,184386,4679,786,21,,490,0,156,,,,,B
20200429,WI,74290,3364,7660,269,66630,3095,308,8,1489,577,33,121,363,,,,A
20200429,WV,43071,16,1095,16,41976,0,38,1,,102,0,40,,21,,504,C
20200429,WY,9217,602,536,147,8681,455,7,0,56,12,0,,,,,362,C
20200428,AK,17089,833,351,6,16738,827,9,0,,16,0,,,,,228,B
20200428,AL,75827,1830,6687,188,69140,1642,242,20,911,,39,,335,,195,,B
20200428,AR,40671,214,3111,94,37560,120,52,2,,104,0,,,20,,1146,B
20200428,AS,3,0,0,0,3,0,0,0,,,0,,,,,,F
20200428,AZ,67438,895,6948,232,60490,663,293,18,1824,737,52,303,,193,,1450,A+
20200428,CA,577608,24199,45031,1567,532577,22632,1809,54,,4983,0,1485,,,,,B
20200428,CO,66341,3067,13879,438,52462,2629,706,26,2485,994,47,,,,,2275,B
20200428,CT,92745,12934,26312,1043,66433,11891,2089,91,,1732,0,,,,,,C
20200428,DC,18885,469,3994,102,14891,367,190,5,,,0,,,,,660,B
20200428,DE,21180,1564,4575,413,16605,1151,192,11,,337,0,,,,,1096,B
20200428,FL,366875,10412,32846,708,334029,9704,1154,53,5266,,55,,,,,,C
20200428,GA,140020,12851,24615,702,115405,12149,1026,55,4814,,133,,1087,,,,B
20200428,GU,1683,115,145,1,1538,114,5,0,,3,0,,,,,129,D
20200428,HI,29183,173,607,1,28576,172,16,2,68,,0,,,,,493,C
20200428,IA,39823,1673,6376,508,33447,1165,136,9,,304,0,98,,64,,2164,B
20200428,ID,20052,28,1917,20,18135,8,58,2,172,41,3,,73,,,1039,C
20200428,IL,242189,14561,48102,2219,194087,12342,2125,142,,4738,0,1245,,778,,,A
20200428,IN,87181,2705,16588,627,70593,2078,901,57,,1518,0,546,,275,,,B
20200428,KS,28090,923,3491,163,24599,760,124,4,504,,8,,,,,,C
20200428,KY,48799,325,4146,72,44653,253,213,5,1281,313,7,165,612,,,1521,A
20200428,LA,151108,4119,27286,218,123822,3901,1758,61,,1666,0,,,244,,17303,B
20200428,MA,254500,9613,58302,1840,196198,7773,3153,150,5515,3875,278,1005,,,,,B
20200428,MD,107785,2809,20113,626,87672,2183,1099,54,4268,1528,167,551,,,,1295,A
20200428,ME,17824,17,1040,17,16784,0,51,0,163,33,2,17,,7,,585,B
20200428,MI,194448,8767,45538,829,148910,7938,4247,99,,2623,0,1027,,801,,8342,A+
20200428,MN,70036,3346,6788,601,63248,2745,301,15,912,314,51,120,324,,,1611,A
20200428,MO,73503,2397,7303,132,66200,2265,314,26,,655,0,,,105,,,B
20200428,MP,65,0,14,0,51,0,2,0,,,0,,,,,12,D
20200428,MS,64412,950,6342,248,58070,702,239,10,1088,639,28,162,,77,,,B
20200428,MT,13191,158,451,2,12740,156,15,1,61,10,0,,,,,356,C
20200428,NC,112752,2832,9568,426,103184,2406,342,36,,463,0,,,,,,B
20200428,ND,23723,1289,991,49,22732,1240,19,0,79,25,2,,,,,409,C
20200428,NE,23605,1242,3358,330,20247,912,55,-1,,,0,,,,,,D
20200428,NH,20145,421,1938,74,18207,347,60,0,246,99,4,,,,,798,C
20200428,NJ,234359,6584,113856,2668,120503,3916,6442,398,,6476,0,1809,,1262,,15642,A+
20200428,NM,58803,2188,2823,97,55980,2091,104,5,481,155,69,,,,,666,C
20200428,NV,40119,1306,4805,115,35314,1191,251,6,,,0,,,,,,F
20200428,NY,844994,18899,295106,3110,549888,15789,17638,335,75362,12646,760,4071,,,,51673,B
20200428,OH,123347,3330,16769,444,106578,2886,799,46,3340,,108,,1004,,,,B
20200428,OK,59699,6528,3410,130,56289,6398,207,10,656,288,0,118,,,,2260,A
20200428,OR,51198,0,2354,0,48844,0,92,0,554,249,0,71,,31,,,B
20200428,PA,209088,5666,43264,1214,165824,4452,1716,119,,2781,0,,,616,,,B
20200428,PR,10713,11,1400,11,9313,0,86,2,,132,0,,,,,,D
20200428,RI,53985,2098,8296,324,45689,1774,239,6,732,266,14,84,,55,,466,A+
20200428,SC,52145,1384,5613,123,46532,1261,177,3,944,,0,,,,,2830,B
20200428,SD,16612,237,2313,68,14299,169,11,0,157,69,7,,,,,1392,C
20200428,TN,161928,7526,10052,134,151876,7392,188,4,894,611,57,,,,,4921,B
20200428,TX,300384,9867,26171,874,274213,8993,690,27,,1682,0,,,,,11786,B
20200428,UT,102439,2244,4343,110,98096,2134,45,4,370,,21,,,,,1704,C
20200428,VA,83298,2619,14339,804,68959,1815,492,34,3422,1508,124,376,,217,,1914,B
20200428,VI,778,3,59,0,719,3,4,0,,,0,,,,,51,D
20200428,VT,14809,128,862,0,13947,128,47,0,,29,0,,,,,,C
20200428,WA,195505,5347,15798,232,179707,5115,765,16,,436,0,158,,,,,B
20200428,WI,70926,2454,7391,230,63535,2224,300,19,1456,544,41,123,363,,,,A
20200428,WV,43055,16,1079,16,41976,0,37,1,,87,0,28,,15,,481,B
20200428,WY,8615,448,389,19,8226,429,7,0,56,16,2,,,,,343,C
20200427,AK,16256,79,345,4,15911,75,9,0,,10,0,,,,,218,B
20200427,AL,73997,446,6499,229,67498,217,222,6,872,,27,,335,,195,,B
20200427,AR,40457,988,3017,76,37440,912,50,1,,109,-291,,,25,,987,B
20200427,AS,3,0,0,0,3,0,0,0,,,0,,,,,,F
20200427,AZ,66543,1732,6716,190,59827,1542,275,0,1772,647,56,328,,200,,1418,A+
20200427,CA,553409,27325,43464,1300,509945,26025,1755,45,,4878,0,1499,,,,,B
20200427,CO,63274,3483,13441,473,49833,3010,680,8,2438,1007,28,,,,,2150,B
20200427,CT,79811,0,25269,0,54542,0,1998,74,,1758,0,,,,,,C
20200427,DC,18416,348,3892,51,14524,297,185,7,,402,0,,,,,659,B
20200427,DE,19616,367,4162,128,15454,239,181,13,,325,0,,,,,996,B
20200427,FL,356463,11850,32138,610,324325,11240,1101,7,5211,,56,,,,,,C
20200427,GA,127169,3946,23913,512,103256,3434,971,59,4681,,322,,1057,,,,B
20200427,GU,1568,40,144,3,1424,37,5,0,,3,0,,,,,128,D
20200427,HI,29010,527,606,3,28404,524,14,0,68,,0,,,,,488,C
20200427,IA,38150,2060,5868,392,32282,1668,127,9,,300,0,100,,58,,2021,B
20200427,ID,20024,526,1897,10,18127,516,56,0,169,36,0,,71,,,983,C
20200427,IL,227628,12676,45883,1980,181745,10696,1983,50,,4672,0,1249,,763,,,A
20200427,IN,84476,2768,15961,949,68515,1819,844,31,,1493,0,581,,284,,,B
20200427,KS,27167,940,3328,154,23839,786,120,2,496,,11,,,,,,C
20200427,KY,48474,1916,4074,169,44400,1747,208,3,1274,308,8,166,608,,,1511,A
20200427,LA,146989,3953,27068,295,119921,3658,1697,27,,1683,0,,,262,,17303,B
20200427,MA,244887,8787,56462,1524,188425,7263,3003,104,5237,3892,133,1089,,,,,B
20200427,MD,104976,8311,19487,906,85489,7405,1045,44,4101,1513,139,535,,,,1263,A
20200427,ME,17807,8,1023,8,16784,0,51,1,161,39,2,16,,7,,549,B
20200427,MI,185681,7461,44709,920,140972,6541,4148,112,,2667,0,1059,,832,,8342,A+
20200427,MN,66690,2017,6187,675,60503,1342,286,14,861,292,32,122,316,,,1556,A
20200427,MO,71106,1358,7171,174,63935,1184,288,14,,679,0,,,109,,,B
20200427,MP,65,0,14,0,51,0,2,0,,,0,,,,,11,D
20200427,MS,63462,2674,6094,183,57368,2491,229,2,1060,590,59,142,,71,,,B
20200427,MT,13033,171,449,1,12584,170,14,0,61,11,0,,,,,352,C
20200427,NC,109920,2026,9142,312,100778,1714,306,7,,473,0,,,,,,B
20200427,ND,22434,1717,942,75,21492,1642,19,2,77,23,6,,,,,350,C
20200427,NE,22363,1135,3028,296,19335,839,56,3,,,0,,,,,,D
20200427,NH,19724,973,1864,77,17860,896,60,0,242,101,4,,,,,779,C
20200427,NJ,227775,4631,111188,2150,116587,2481,6044,106,,6407,0,1801,,1303,,,A
20200427,NM,56615,2880,2726,66,53889,2814,99,6,412,148,0,,,,,650,C
20200427,NV,38813,627,4690,88,34123,539,245,10,,,0,,,,,,F
20200427,NY,826095,20745,291996,3951,534099,16794,17303,337,74602,12819,1062,4157,,,,50751,B
20200427,OH,120017,3631,16325,362,103692,3269,753,25,3232,,54,,978,,,,B
20200427,OK,53171,27,3280,27,49891,0,197,2,656,306,3,150,,,,2167,A
20200427,OR,51198,2234,2354,43,48844,2191,92,1,554,249,8,71,,31,,,B
20200427,PA,203422,4829,42050,885,161372,3944,1597,47,,2800,0,,,629,,,B
20200427,PR,10702,18,1389,18,9313,0,84,0,,140,0,,,,,,D
20200427,RI,51887,1372,7972,203,43915,1169,233,7,718,266,27,81,,56,,452,A+
20200427,SC,50761,0,5490,0,45271,0,174,0,944,,0,,,,,3701,B
20200427,SD,16375,101,2245,33,14130,68,11,0,150,61,15,,,,,1316,C
20200427,TN,154402,6928,9918,251,144484,6677,184,3,837,618,9,,,,,4720,B
20200427,TX,290517,14496,25297,666,265220,13830,663,15,,1563,0,,,,,11170,B
20200427,UT,100195,4493,4233,110,95962,4383,41,0,349,,4,,,,,1641,C
20200427,VA,80679,4079,13535,565,67144,3514,458,10,3298,1455,1284,389,,217,,1843,B
20200427,VI,775,18,59,2,716,16,4,0,,,0,,,,,51,D
20200427,VT,14681,308,862,7,13819,301,47,1,,33,0,,,,,,C
20200427,WA,190158,5117,15566,274,174592,4843,749,11,,536,0,115,,,,,B
20200427,WI,68472,2274,7161,198,61311,2076,281,9,1415,337,18,124,355,,,,A
20200427,WV,43039,3976,1063,19,41976,3957,36,2,,100,0,38,,20,,455,B
20200427,WY,8167,8,370,8,7797,0,7,0,54,16,0,,,,,342,C
20200426,AK,16177,445,341,2,15836,443,9,0,,14,0,,,,,217,B
20200426,AL,73551,2207,6270,133,67281,2074,216,4,845,,6,,288,,170,,B
20200426,AR,39469,1416,2941,112,36528,1304,49,2,291,104,0,,,25,57,985,B
20200426,AS,3,0,0,0,3,0,0,0,,,0,,,,,,F
20200426,AZ,64811,2303,6526,246,58285,2057,275,9,1716,671,44,308,,200,,1383,A+
20200426,CA,526084,20049,42164,1027,483920,19022,1710,59,,4928,0,1473,,,,,B
20200426,CO,59791,3002,12968,712,46823,2290,672,-2,2410,1046,44,,,,,2150,B
20200426,CT,79811,2209,25269,687,54542,1522,1924,62,,1766,0,,,,,,C
20200426,DC,18068,766,3841,142,14227,624,178,13,,402,0,120,,69,,657,B
20200426,DE,19249,1551,4034,458,15215,1093,168,13,,317,0,,,,,911,B
20200426,FL,344613,11514,31528,689,313085,10825,1094,19,5155,,110,,,,,,C
20200426,GA,123223,4209,23401,706,99822,3503,912,8,4359,,33,,,,,,B
20200426,GU,1528,79,141,0,1387,79,5,0,,2,0,,,,,128,D
20200426,HI,28483,443,603,2,27880,441,14,1,68,,1,,,,,482,C
20200426,IA,36090,1740,5476,384,30614,1356,118,6,,286,0,99,,55,,1900,B
20200426,ID,19498,17,1887,17,17611,0,56,2,169,38,1,,72,,,938,C
20200426,IL,214952,13335,43903,2126,171049,11209,1933,59,,4595,0,1267,,772,,,A
20200426,IN,81708,1934,15012,617,66696,1317,813,28,,1446,0,589,,310,,,B
20200426,KS,26227,1028,3174,118,23053,910,118,1,485,,11,,,,,,C
20200426,KY,46558,1596,3905,126,42653,1470,205,5,1266,301,123,164,605,,,1501,A
20200426,LA,143036,4034,26773,261,116263,3773,1670,26,,1701,0,,,265,,14927,B
20200426,MA,236100,9255,54938,1590,181162,7665,2899,22,5104,3879,139,1077,,,,,B
20200426,MD,96665,7542,18581,815,78084,6727,1001,53,3962,1463,202,530,,,,1177,A
20200426,ME,17799,25,1015,25,16784,0,50,0,159,39,3,19,,7,,532,B
20200426,MI,178220,6002,43789,526,134431,5476,4036,107,,2757,0,1099,,871,,8342,A+
20200426,MN,64673,2564,5512,385,59161,2179,272,28,829,285,32,115,301,,,1502,A
20200426,MO,69748,2530,6997,171,62751,2359,274,1,,679,0,,,109,,,B
20200426,MP,65,0,14,0,51,0,2,0,,,0,,,,,11,D
20200426,MS,60788,1831,5911,193,54877,1638,227,6,1001,644,5,146,,67,,,B
20200426,MT,12862,365,448,3,12414,362,14,0,61,11,0,,,,,339,C
20200426,NC,107894,2629,8830,207,99064,2422,299,10,,451,0,,,,,,B
20200426,ND,20717,1367,867,64,19850,1303,17,1,71,18,1,,,,,326,C
20200426,NE,21228,1255,2732,311,18496,944,53,3,,,0,,,,,,D
20200426,NH,18751,1024,1787,67,16964,957,60,7,238,95,14,,,,,777,C
20200426,NJ,223144,9458,109038,3515,114106,5943,5938,75,,6573,0,1804,,1418,,,A
20200426,NM,53735,2225,2660,139,51075,2086,93,9,412,152,0,,,,,614,C
20200426,NV,38186,978,4602,63,33584,915,235,6,,,0,,,,,,F
20200426,NY,805350,27782,288045,5902,517305,21880,16966,367,73540,12839,1096,4284,,,,49687,B
20200426,OH,116386,4403,15963,376,100423,4027,728,17,3178,,63,,952,,,,B
20200426,OK,53144,60,3253,60,49891,0,195,1,653,306,16,150,,,,2139,A
20200426,OR,48964,1587,2311,58,46653,1529,91,4,546,249,10,71,,31,,,B
20200426,PA,198593,5658,41165,1116,157428,4542,1550,13,,2736,0,,,632,,,B
20200426,PR,10684,64,1371,64,9313,0,84,1,,146,0,,,,,,D
20200426,RI,50515,2162,7769,276,42746,1886,226,11,691,258,115,78,,53,,433,A+
20200426,SC,50761,1747,5490,237,45271,1510,174,8,944,,0,,,,,3701,B
20200426,SD,16274,678,2212,65,14062,613,11,1,135,64,7,,,,,1257,C
20200426,TN,147474,6068,9667,478,137807,5590,181,3,828,568,7,,,,,4527,B
20200426,TX,276021,13205,24631,858,251390,12347,648,25,,1542,0,,,,,10763,B
20200426,UT,95702,5496,4123,175,91579,5321,41,0,345,,16,,,,,1568,C
20200426,VA,76600,3958,12970,604,63630,3354,448,12,2014,1436,72,387,,217,,1815,B
20200426,VI,757,9,57,2,700,7,4,1,,,0,,,,,51,D
20200426,VT,14373,251,855,3,13518,248,46,0,,34,0,,,,,,C
20200426,WA,185041,1778,15292,182,169749,1596,738,73,,508,0,145,,,,,B
20200426,WI,66198,2345,6963,248,59235,2097,272,6,1397,337,21,136,353,,,,A
20200426,WV,39063,6097,1044,24,38019,6073,34,2,,100,0,38,,20,,455,B
20200426,WY,8159,13,362,13,7797,0,7,0,54,16,0,,,,,334,C
20200425,AK,15732,3451,339,0,15393,3451,9,0,,32,0,,,,,217,B
20200425,AL,71344,18649,6137,305,65207,18344,212,15,839,,71,,288,,170,,B
20200425,AR,38053,2475,2829,88,35224,2387,47,2,291,104,0,,,25,57,964,B
20200425,AS,3,0,0,0,3,0,0,0,,,0,,,,,,F
20200425,AZ,62508,1794,6280,235,56228,1559,266,0,1672,697,46,313,,191,,1345,A+
20200425,CA,506035,11862,41137,1883,464898,9979,1651,89,,4847,0,1458,,,,,B
20200425,CO,56789,4465,12256,994,44533,3471,674,122,2366,1084,129,,,,,2086,B
20200425,CT,77602,3564,24582,661,53020,2903,1862,98,,1810,0,,,,,,C
20200425,DC,17302,769,3699,171,13603,598,165,12,,402,0,120,,69,,652,B
20200425,DE,17698,319,3576,134,14122,185,155,8,,300,0,,,,,809,B
20200425,FL,333099,16140,30839,665,302260,15475,1075,44,5045,,157,,,,,,C
20200425,GA,119014,11838,22695,548,96319,11290,904,12,4326,,105,,,,,,B
20200425,GU,1449,75,141,0,1308,75,5,0,,2,0,,,,,128,D
20200425,HI,28040,1153,601,5,27439,1148,13,1,67,,4,,,,,463,C
20200425,IA,34350,2377,5092,647,29258,1730,112,5,,293,0,108,,60,,1723,B
20200425,ID,19481,34,1870,34,17611,0,54,0,168,35,2,,71,,,867,C
20200425,IL,201617,11985,41777,2119,159840,9866,1874,79,,4699,0,1244,,763,,,A
20200425,IN,79774,4221,14395,715,65379,3506,785,44,,1515,0,598,,324,,,B
20200425,KS,25199,1611,3056,279,22143,1332,117,6,474,,17,,,,,,C
20200425,KY,44962,2118,3779,298,41183,1820,200,9,1143,303,28,164,575,,,1341,A
20200425,LA,139002,890,26512,372,112490,518,1644,43,,1700,0,,,268,,14927,B
20200425,MA,226845,11632,53348,2379,173497,9253,2877,0,4965,3879,213,1058,,,,,B
20200425,MD,89123,4407,17766,1150,71357,3257,948,49,3760,1408,142,538,,,,1165,A
20200425,ME,17774,25,990,25,16784,0,50,3,156,39,4,17,,7,,519,B
20200425,MI,172218,6434,43263,533,128955,5901,3929,111,,2889,0,1164,,934,,8342,A+
20200425,MN,62109,2615,5127,339,56982,2276,244,23,797,288,41,109,291,,,1410,A
20200425,MO,67218,2011,6826,201,60392,1810,273,11,,850,0,,,142,,,B
20200425,MP,65,0,14,0,51,0,2,0,,,0,,,,,11,D
20200425,MS,58957,3287,5718,284,53239,3003,221,12,996,649,26,152,,78,,,B
20200425,MT,12497,370,445,1,12052,369,14,0,61,11,2,,,,,339,C
20200425,NC,105265,4681,8623,571,96642,4110,289,20,,456,0,,,,,,B
20200425,ND,19350,1901,803,55,18547,1846,16,1,70,17,3,,,,,310,C
20200425,NE,19973,1361,2421,297,17552,1064,50,3,,,0,,,,,,D
20200425,NH,17727,918,1720,50,16007,868,53,2,224,89,6,,,,,578,C
20200425,NJ,213686,7724,105523,3327,108163,4397,5863,246,,6722,0,1971,,1442,,,A
20200425,NM,51510,4947,2521,142,48989,4805,84,6,412,152,45,,,,,614,C
20200425,NV,37208,1016,4539,141,32669,875,229,13,,,0,,,,,,F
20200425,NY,777568,46912,282143,10553,495425,36359,16599,437,72444,13524,1071,4410,,,,47935,B
20200425,OH,111983,4286,15587,418,96396,3868,711,21,3115,,62,,938,,,,B
20200425,OK,53084,6944,3193,72,49891,6872,194,6,637,306,0,150,,,,2080,A
20200425,OR,47377,1885,2253,76,45124,1809,87,1,536,261,16,60,,29,,,B
20200425,PA,192935,6792,40049,1397,152886,5395,1537,45,,2748,0,,,640,,,B
20200425,PR,10620,31,1307,31,9313,0,83,6,,137,0,,,,,,D
20200425,RI,48353,2094,7493,305,40860,1789,215,13,576,263,0,77,,52,,410,A+
20200425,SC,49014,4551,5253,336,43761,4215,166,16,944,,107,,,,,3701,B
20200425,SD,15596,772,2147,107,13449,665,10,0,128,61,4,,,,,1223,C
20200425,TN,141406,10078,9189,463,132217,9615,178,10,821,510,13,,,,,4467,B
20200425,TX,262816,20269,23773,967,239043,19302,623,30,,1597,0,,,,,9986,B
20200425,UT,90206,5509,3948,166,86258,5343,41,2,329,,14,,,,,1399,C
20200425,VA,72642,3202,12366,772,60276,2430,436,26,1942,1405,105,357,,223,,1717,B
20200425,VI,748,52,55,1,693,51,3,0,,,0,,,,,51,D
20200425,VT,14122,471,852,9,13270,462,46,2,,37,0,,,,,,C
20200425,WA,183263,3011,15110,197,168153,2814,665,6,,455,0,174,,,,,B
20200425,WI,63853,2916,6715,351,57138,2565,266,4,1376,337,23,136,353,,,,A
20200425,WV,32966,3155,1020,32,31946,3123,32,0,,97,0,36,,19,,439,B
20200425,WY,8146,101,349,0,7797,101,7,0,54,16,0,,,,,321,C
20200424,AK,12281,120,339,2,11942,118,9,0,,36,0,,,,,208,A
20200424,AL,52695,54,5832,54,46863,0,197,0,768,,0,,288,,170,,B
20200424,AR,35578,3988,2741,276,32837,3712,45,0,291,101,0,,,24,57,929,A
20200424,AS,3,0,0,0,3,0,,0,,,0,,,,,,
20200424,AZ,60714,2017,6045,276,54669,1741,266,17,1626,639,54,332,,186,,1313,B
20200424,CA,494173,12076,39254,1885,454919,10191,1562,93,,4880,0,1521,,,,,B
20200424,CO,52324,1679,11262,384,41062,1295,552,44,2237,1084,114,,,,,,A
20200424,CT,74038,2541,23921,821,50117,1720,1764,125,,1877,0,,,,,,A
20200424,DC,16533,603,3528,167,13005,436,153,14,,402,0,120,,69,,651,A
20200424,DE,17379,467,3442,134,13937,333,147,16,,277,0,,,,,703,A
20200424,FL,316959,20251,30174,1342,286785,18909,1031,52,4888,,195,,,,,,A
20200424,GA,107176,6114,22147,635,85029,5479,892,20,4221,,152,,,,,,A
20200424,GU,1374,59,141,6,1233,53,5,0,,2,0,,,,,126,
20200424,HI,26887,759,596,4,26291,755,12,0,63,,0,,,,,455,A
20200424,IA,31973,2711,4445,521,27528,2190,107,11,,278,0,104,,60,,1604,A
20200424,ID,19447,275,1836,34,17611,241,54,0,166,31,4,,63,,,822,A
20200424,IL,189632,16316,39658,2724,149974,13592,1795,107,,4828,0,1225,,709,,,A
20200424,IN,75553,3513,13680,641,61873,2872,741,35,,,0,621,,325,,,B
20200424,KS,23588,2270,2777,295,20811,1975,111,-1,457,,15,,,,,,B
20200424,KY,42844,6769,3481,108,39363,6661,191,6,1115,302,10,163,570,,,1335,A
20200424,LA,138112,599,26140,401,111972,198,1601,61,,1697,0,,,286,,14927,A
20200424,MA,215213,10897,50969,2977,164244,7920,2877,108,4752,3847,259,1034,,,,,B
20200424,MD,84716,4616,16616,879,68100,3737,899,68,3618,1425,141,547,,,,1108,A
20200424,ME,17749,28,965,28,16784,0,47,3,152,39,2,17,,7,,499,A
20200424,MI,165784,9085,42730,1036,123054,8049,3818,107,,3022,0,1176,,965,,3237,B
20200424,MN,59494,3080,4788,518,54706,2562,221,21,756,278,44,111,281,,,1373,A
20200424,MO,65207,5757,6625,304,58582,5453,262,44,,877,0,,,,,,A
20200424,MP,65,0,14,0,51,0,2,0,,,0,,,,,11,
20200424,MS,55670,281,5434,281,50236,0,209,8,970,586,24,148,,74,,,A
20200424,MT,12127,252,444,2,11683,250,14,0,59,12,0,,,,,325,A
20200424,NC,100584,4399,8052,444,92532,3955,269,16,,477,0,,,,,,A
20200424,ND,17449,1119,748,39,16701,1080,15,0,67,17,2,,,,,285,B
20200424,NE,18612,1252,2124,311,16488,941,47,2,,,0,,,,,,A
20200424,NH,16809,797,1670,82,15139,715,51,3,218,92,5,,,,,551,B
20200424,NJ,205962,5814,102196,2207,103766,3607,5617,249,,6847,0,1933,,1487,,,A
20200424,NM,46563,5331,2379,169,44184,5162,78,7,367,123,36,,,,,573,A
20200424,NV,36192,1443,4398,190,31794,1253,216,6,,,0,,,,,,A
20200424,NY,730656,34736,271590,8130,459066,26606,16162,422,71373,14258,1191,4540,,,,46156,A
20200424,OH,107697,4820,15169,475,92528,4345,690,34,3053,,93,,920,,,,B
20200424,OK,46140,104,3121,104,43019,0,188,9,637,310,15,155,,,,1961,B
20200424,OR,45492,1516,2177,50,43315,1466,86,3,520,258,8,56,,29,,,A
20200424,PA,186143,7029,38652,1599,147491,5430,1492,71,,2746,0,,,679,,,A
20200424,PR,10589,361,1276,361,9313,0,77,8,,172,0,,,,,,A
20200424,RI,46259,3063,7188,415,39071,2648,202,-11,576,267,-181,77,,48,,377,B
20200424,SC,44463,0,4917,0,39546,0,150,0,837,,0,,,,,3317,B
20200424,SD,14824,759,2040,84,12784,675,10,1,124,61,5,,,,,1190,A
20200424,TN,131328,8228,8726,460,122602,7768,168,-2,808,593,15,,,,,4370,A
20200424,TX,242547,17469,22806,862,219741,16607,593,32,,1674,0,,,,,9156,A
20200424,UT,84697,4070,3782,170,80915,3900,39,4,315,,14,,,,,1252,A
20200424,VA,69440,4551,11594,596,57846,3955,410,38,1837,1399,84,379,,220,,1672,A
20200424,VI,696,59,54,0,642,59,3,0,,,0,,,,,50,
20200424,VT,13651,397,843,9,12808,388,44,1,,32,0,,,,,,A
20200424,WA,180252,5509,14913,285,165339,5224,659,5,,551,0,164,,,,,C
20200424,WI,60937,3470,6364,353,54573,3117,262,5,1353,361,35,143,346,,,,A
20200424,WV,29811,1906,988,21,28823,1885,32,3,,97,0,36,,19,,439,B
20200424,WY,8045,478,349,23,7696,455,7,0,54,16,2,,,,,321,A
20200423,AK,12161,2,337,2,11824,0,9,0,,42,-36,,,,,209,A
20200423,AL,52641,3881,5778,313,46863,3568,197,3,768,,38,,288,,170,,B
20200423,AR,31590,1877,2465,189,29125,1688,45,3,291,101,0,,,24,57,902,A
20200423,AS,3,0,0,0,3,0,,0,,,0,,,,,,
20200423,AZ,58697,2096,5769,310,52928,1786,249,20,1572,699,44,305,,201,,1282,B
20200423,CA,482097,16770,37369,1973,444728,14797,1469,115,,4929,0,1531,,,,,B
20200423,CO,50645,1941,10878,431,39767,1510,508,22,2123,859,120,,,,,,A
20200423,CT,71497,1579,23100,631,48397,948,1639,95,,1947,0,,,,,,A
20200423,DC,15930,428,3361,155,12569,273,139,12,,402,0,120,,200,,648,A
20200423,DE,16912,359,3308,108,13604,251,131,14,,290,0,,,,,643,A
20200423,FL,296708,8081,28832,523,267876,7558,979,69,4693,,224,,,,,,A
20200423,GA,101062,6990,21512,772,79550,6218,872,36,4069,,110,,,,,,A
20200423,GU,1315,95,135,1,1180,94,5,0,,2,0,,,,,126,
20200423,HI,26128,786,592,10,25536,776,12,0,63,,7,,,,,444,A
20200423,IA,29262,1018,3924,176,25338,842,96,6,,282,0,102,,55,,1492,A
20200423,ID,19172,1002,1802,36,17370,966,54,3,162,52,4,,60,,,767,A
20200423,IL,173316,8970,36934,1826,136382,7144,1688,123,,4877,0,1268,,766,,,A
20200423,IN,72040,2570,13039,601,59001,1969,706,45,,,0,652,,333,,,B
20200423,KS,21318,1115,2482,271,18836,844,112,2,442,,10,,,,,,B
20200423,KY,36075,2747,3373,181,32702,2566,185,14,1105,301,29,161,564,,,1311,A
20200423,LA,137513,667,25739,481,111774,186,1540,67,,1727,0,,,274,,14927,A
20200423,MA,204316,14614,47992,3079,156324,11535,2769,172,4493,3851,237,1034,,,,,B
20200423,MD,80100,3571,15737,962,64363,2609,831,52,3477,1405,152,515,,,,1040,A
20200423,ME,17721,30,937,30,16784,0,44,5,150,42,6,18,,11,,485,A
20200423,MI,156699,9341,41694,989,115005,8352,3711,109,,3611,0,1148,,1027,,3237,B
20200423,MN,56414,2491,4270,512,52144,1979,200,21,712,268,52,104,274,,,1336,A
20200423,MO,59450,1294,6321,184,53129,1110,218,10,,884,0,,,,,,A
20200423,MP,65,0,14,0,51,0,2,0,,,0,,,,,11,
20200423,MS,55389,1554,5153,259,50236,1295,201,8,946,595,36,156,,78,,,A
20200423,MT,11875,292,442,3,11433,289,14,0,59,13,0,,,,,306,A
20200423,NC,96185,5849,7608,388,88577,5461,253,11,,486,0,,,,,,A
20200423,ND,16330,741,709,30,15621,711,15,1,65,18,3,,,,,269,B
20200423,NE,17360,681,1813,91,15547,590,45,7,,,0,,,,,,A
20200423,NH,16012,971,1588,97,14424,874,48,6,213,91,7,,,,,550,B
20200423,NJ,200148,8489,99989,4124,100159,4365,5368,305,,7240,0,1990,,1462,,,A
20200423,NM,41232,355,2210,138,39022,217,71,6,331,121,25,,,,,547,A
20200423,NV,34749,861,4208,127,30541,734,210,9,,,0,,,,,,A
20200423,NY,695920,25938,263460,6244,432460,19694,15740,438,70182,15021,1409,4597,,,,44244,A
20200423,OH,102877,4371,14694,577,88183,3794,656,46,2960,,78,,900,,,,B
20200423,OK,46036,123,3017,123,43019,0,179,9,622,284,34,156,,,,1884,B
20200423,OR,43976,2791,2127,68,41849,2723,83,5,512,304,24,74,,36,,,A
20200423,PA,179114,7158,37053,1369,142061,5789,1421,-201,,2750,0,,,679,,,A
20200423,PR,10228,471,915,0,9313,471,69,2,,154,0,,,,,,A
20200423,RI,43196,2314,6773,419,36423,1895,213,12,757,316,40,72,,45,,342,B
20200423,SC,44463,1352,4917,156,39546,1196,150,10,837,,0,,,,,3317,B
20200423,SD,14065,619,1956,98,12109,521,9,1,119,58,8,,,,,1064,A
20200423,TN,123100,8120,8266,424,114834,7696,170,4,793,488,18,,,,,4193,A
20200423,TX,225078,8295,21944,875,203134,7420,561,18,,1649,0,,,,,8025,A
20200423,UT,80627,4167,3612,167,77015,4000,35,1,301,,13,,,,,1050,A
20200423,VA,64889,4111,10998,732,53891,3379,372,23,1753,1379,94,400,,249,,1567,A
20200423,VI,637,0,54,0,583,0,3,0,,,0,,,,,48,
20200423,VT,13254,326,834,3,12420,323,43,3,,44,0,,,,,,A
20200423,WA,174743,4338,14628,253,160115,4085,654,7,,544,0,151,,,,,C
20200423,WI,57467,2199,6011,245,51456,1954,257,11,1318,349,16,146,342,,,,A
20200423,WV,27905,2069,967,28,26938,2041,29,3,,108,0,44,,24,,380,B
20200423,WY,7567,-56,326,4,7241,-60,7,1,52,,0,,,,,275,A
20200422,AK,12159,1040,335,6,11824,1034,9,0,36,39,0,,,,,196,A
20200422,AL,48760,234,5465,234,43295,0,194,17,730,,31,,288,,170,,B
20200422,AR,29713,2272,2276,49,27437,2223,42,-1,291,97,0,,,23,57,863,A
20200422,AS,3,0,0,0,3,0,,0,,,0,,,,,,
20200422,AZ,56601,1449,5459,208,51142,1241,229,21,1528,664,44,300,,195,,1265,B
20200422,CA,465327,165227,35396,2135,429931,163092,1354,86,,4984,0,1551,,,,,B
20200422,CO,48704,1238,10447,341,38257,897,486,37,2003,851,123,,,,,,A
20200422,CT,69918,5726,22469,2109,47449,3617,1544,121,,1972,0,,,,,,A
20200422,DC,15502,563,3206,108,12296,455,127,15,,402,0,120,,69,,645,A
20200422,DE,16553,687,3200,269,13353,418,117,13,,269,0,,,,,599,A
20200422,FL,288627,11568,28309,814,260318,10754,910,54,4469,,234,,,,,,A
20200422,GA,94072,5932,20740,859,73332,5073,836,37,3959,,180,,,,,,A
20200422,GU,1220,54,134,1,1086,53,5,0,,3,0,2,,,,119,
20200422,HI,25342,646,582,-2,24760,648,12,2,56,,1,,,,,437,A
20200422,IA,28244,629,3748,107,24496,522,90,7,,272,0,92,,57,,1428,A
20200422,ID,18170,363,1766,30,16404,333,51,3,158,54,1,,58,,,710,A
20200422,IL,164346,9349,35108,2049,129238,7300,1565,97,,4665,0,1220,,747,,,A
20200422,IN,69470,2206,12438,341,57032,1865,661,31,,,0,633,,334,,,B
20200422,KS,20203,1102,2211,186,17992,916,110,3,432,,13,,,,,,B
20200422,KY,33328,508,3192,142,30136,366,171,17,1076,286,17,165,558,,,1266,A
20200422,LA,136846,404,25258,404,111588,0,1473,68,,1747,0,,,287,,14927,A
20200422,MA,189702,5090,44913,1745,144789,3345,2597,148,4256,3890,247,1050,,,,,B
20200422,MD,76529,2894,14775,582,61754,2312,779,47,3325,1432,167,527,,,,981,A
20200422,ME,17691,2727,907,19,16784,2708,39,3,144,42,5,18,,10,,455,A
20200422,MI,147358,8102,40705,1116,106653,6986,3602,131,,3305,0,1350,,1065,,3237,B
20200422,MN,53923,2130,3758,306,50165,1824,179,19,660,240,31,107,262,,,1138,A
20200422,MO,58156,1036,6137,196,52019,840,208,19,,1001,0,,,,,,A
20200422,MP,65,0,14,0,51,0,2,0,,,0,,,,,11,
20200422,MS,53835,1471,4894,178,48941,1293,193,10,910,628,52,162,,86,,,A
20200422,MT,11583,342,439,2,11144,340,14,2,59,13,0,,,,,296,A
20200422,NC,90336,7005,7220,269,83116,6736,242,29,,434,0,,,,,,A
20200422,ND,15589,602,679,35,14910,567,14,1,62,23,8,,,,,229,B
20200422,NE,16679,307,1722,74,14957,233,38,5,,,0,,,,,,A
20200422,NH,15041,702,1491,0,13550,702,42,0,206,94,0,,,,,546,B
20200422,NJ,191659,6833,95865,3478,95794,3355,5063,310,,7210,0,1983,,1570,,,A
20200422,NM,40877,2122,2072,101,38805,2021,65,7,306,119,15,,,,,529,A
20200422,NV,33888,833,4081,144,29807,689,201,8,,,0,,,,,,A
20200422,NY,669982,20657,257216,5526,412766,15131,15302,474,68773,15599,1502,4690,,,,42308,A
20200422,OH,98506,3792,14117,392,84389,3400,610,53,2882,,103,,880,,,,B
20200422,OK,45913,1569,2894,87,43019,1482,170,6,588,298,27,147,,,,1772,B
20200422,OR,41185,57,2059,57,39126,0,78,0,488,302,17,67,,35,,,A
20200422,PA,171956,5105,35684,1156,136272,3949,1622,58,,2764,0,,,685,,,A
20200422,PR,9757,-330,915,-383,8842,53,67,3,,140,0,,,,,,A
20200422,RI,40882,2304,6354,382,34528,1922,201,15,717,314,43,71,,44,,315,B
20200422,SC,43111,1834,4761,322,38350,1512,140,16,837,,61,,,,,3317,B
20200422,SD,13446,631,1858,103,11588,528,8,0,111,62,11,,,,,937,A
20200422,TN,114980,6798,7842,448,107138,6350,166,9,775,441,15,,,,,4012,A
20200422,TX,216783,11384,21069,873,195714,10511,543,26,,1678,0,,,,,7341,A
20200422,UT,76460,4102,3445,149,73015,3953,34,2,288,,11,,,,,970,A
20200422,VA,60778,2424,10266,636,50512,1788,349,25,1659,1374,78,419,,244,,1497,A
20200422,VI,637,9,54,0,583,9,3,0,,,0,,,,,48,
20200422,VT,12928,333,831,3,12097,330,40,0,,37,0,,,,,,A
20200422,WA,170405,4424,14375,242,156030,4182,647,7,,543,0,161,,,,,C
20200422,WI,55268,1918,5766,257,49502,1661,246,4,1302,355,50,139,324,,,,A
20200422,WV,25836,3073,939,25,24897,3048,26,0,,103,0,41,,23,,330,B
20200422,WY,7623,2,322,2,7301,0,6,0,52,19,0,,,,,254,A
20200421,AK,11119,995,329,8,10790,987,9,0,36,42,0,,,,,168,A
20200421,AL,48526,2626,5231,206,43295,2420,177,10,699,,58,,260,,157,,B
20200421,AR,27441,888,2227,304,25214,584,43,1,291,86,0,,,27,57,809,A
20200421,AS,3,0,0,0,3,0,,0,,,0,,,,,,
20200421,AZ,55152,652,5251,187,49901,465,208,21,1484,637,30,285,,181,,1155,B
20200421,CA,300100,9600,33261,2283,266839,7317,1268,60,,4886,0,1502,,,,,B
20200421,CO,47466,1271,10106,376,37360,895,449,27,1880,861,67,,,,,,A
20200421,CT,64192,1386,20360,545,43832,841,1423,92,,1949,0,,,,,,A
20200421,DC,14939,826,3098,171,11841,655,112,7,,402,0,120,,69,,636,A
20200421,DE,15866,613,2931,186,12935,427,104,5,,263,0,,,,,565,A
20200421,FL,277059,10834,27495,835,249564,9999,856,50,4235,,225,,,,,,A
20200421,GA,88140,3812,19881,934,68259,2878,799,66,3779,,229,,,,,,A
20200421,GU,1166,42,133,0,1033,42,5,0,,3,0,2,,,,114,
20200421,HI,24696,521,584,4,24112,517,10,0,55,,3,,,,,423,A
20200421,IA,27615,1795,3641,482,23974,1313,83,4,,214,0,89,,60,,1293,A
20200421,ID,17807,362,1736,64,16071,298,48,3,157,69,6,,58,,,660,A
20200421,IL,154997,6639,33059,1551,121938,5088,1468,119,,4776,0,1226,,781,,,A
20200421,IN,67264,2625,12097,411,55167,2214,630,61,,,0,676,,368,,,B
20200421,KS,19101,340,2025,39,17076,301,107,7,419,,14,,,,,,B
20200421,KY,32820,248,3050,90,29770,158,154,6,1059,263,0,147,582,,,1174,A
20200421,LA,136442,331,24854,331,111588,0,1405,77,,1798,0,,,297,,,A
20200421,MA,184612,7150,43168,1752,141444,5398,2449,146,4009,3977,137,1040,,,,,B
20200421,MD,73635,2238,14193,509,59442,1729,732,49,3158,1433,144,526,,,,930,A
20200421,ME,14964,13,888,13,14076,0,36,1,139,40,1,16,,8,,443,A
20200421,MI,139256,7369,39589,1095,99667,6274,3471,124,,3357,0,1346,,1107,,3237,B
20200421,MN,51793,1749,3452,262,48341,1487,160,17,629,237,27,117,253,,,1094,A
20200421,MO,57120,1107,5941,134,51179,973,189,12,,1001,0,,,,,,A
20200421,MP,65,0,14,0,51,0,2,0,,,0,,,,,11,
20200421,MS,52364,930,4716,204,47648,726,183,14,858,548,39,146,,89,,,A
20200421,MT,11241,190,437,4,10804,186,12,2,59,14,2,,,,,273,A
20200421,NC,83331,3847,6951,187,76380,3660,213,34,,427,0,,,,,,A
20200421,ND,14987,240,644,17,14343,223,13,0,54,17,1,,,,,214,B
20200421,NE,16372,692,1648,174,14724,518,33,5,,,0,,,,,,A
20200421,NH,14339,221,1491,99,12848,122,42,1,206,78,8,,,,,521,B
20200421,NJ,184826,6769,92387,3581,92439,3188,4753,376,,7594,0,1930,,1501,,,A
20200421,NM,38755,1713,1971,126,36784,1587,58,3,291,116,17,,,,,501,A
20200421,NV,33055,708,3937,107,29118,601,193,13,,,0,,,,,,A
20200421,NY,649325,15464,251690,4178,397635,11286,14828,481,67271,16135,1302,4729,,,,40482,A
20200421,OH,94714,3875,13725,806,80989,3069,557,48,2779,,126,,838,,,,B
20200421,OK,44344,8698,2807,127,41537,8571,164,21,561,346,20,164,,,,1702,B
20200421,OR,41128,1083,2002,46,39126,1037,78,3,471,297,6,70,,35,,,A
20200421,PA,166851,3899,34528,1296,132323,2603,1564,360,,2743,0,,,673,,,A
20200421,PR,10087,349,1298,46,8789,303,64,1,,117,0,,,,,,A
20200421,RI,38578,2110,5972,387,32606,1723,186,11,674,309,45,67,,43,,315,B
20200421,SC,41277,797,4439,62,36838,735,124,4,776,,0,,,,,2063,B
20200421,SD,12815,489,1755,70,11060,419,8,1,100,65,13,,,,,824,A
20200421,TN,108182,7493,7394,156,100788,7337,157,5,760,523,30,,,,,3828,A
20200421,TX,205399,15005,20196,738,185203,14267,517,22,,1419,0,,,,,6486,A
20200421,UT,72358,4047,3296,83,69062,3964,32,4,277,,9,,,,,888,A
20200421,VA,58354,1619,9630,640,48724,979,324,24,1581,1331,81,403,,251,,1418,A
20200421,VI,628,21,54,1,574,20,3,0,,,0,,,,,48,
20200421,VT,12595,104,828,8,11767,96,40,2,,41,0,,,,,,A
20200421,WA,165981,4202,14133,243,151848,3959,640,11,,503,0,161,,,,,C
20200421,WI,53350,1394,5509,156,47841,1238,242,12,1252,358,41,137,324,,,,A
20200421,WV,22763,608,914,12,21849,596,26,2,,85,0,42,,24,,330,B
20200421,WY,7621,235,320,7,7301,228,6,4,52,19,1,,,,,237,A
20200420,AK,10124,229,321,2,9803,227,9,0,36,46,0,,,,,161,A
20200420,AL,45900,188,5025,188,40875,0,167,13,641,,0,,260,,157,,B
20200420,AR,26553,2344,1923,142,24630,2202,42,2,291,93,0,,,24,57,749,A
20200420,AS,3,0,0,0,3,0,,0,,,0,,,,,,
20200420,AZ,54500,1510,5064,135,49436,1375,187,3,1454,637,67,285,,181,,1155,B
20200420,CA,290500,9600,30978,645,259522,8955,1208,42,,4674,0,1480,,,,,B
20200420,CO,46195,1589,9730,297,36465,1292,422,11,1813,874,16,,,,,,A
20200420,CT,62806,4593,19815,2265,42991,2328,1331,245,,1919,0,,,,,,A
20200420,DC,14113,414,2927,134,11186,280,105,9,,402,0,120,,69,,630,A
20200420,DE,15253,459,2745,207,12508,252,99,9,,256,0,,,,,495,A
20200420,FL,266225,10146,26660,664,239565,9482,806,25,4010,,80,,,,,,A
20200420,GA,84328,4395,18947,646,65381,3749,733,46,3550,,86,,,,,,A
20200420,GU,1124,48,133,0,991,48,5,0,,3,0,2,,,,112,
20200420,HI,24175,705,580,6,23595,699,10,1,52,,1,,,,,414,A
20200420,IA,25820,1270,3159,257,22661,1013,79,4,,214,0,91,,58,,1235,A
20200420,ID,17445,4,1672,4,15773,0,45,1,151,53,0,,53,,,585,A
20200420,IL,148358,5040,31508,1151,116850,3889,1349,59,,4599,0,1239,,757,,,A
20200420,IN,64639,3497,11686,476,52953,3021,569,7,,,0,669,,353,,,B
20200420,KS,18761,631,1986,137,16775,494,100,8,405,,15,,,,,,B
20200420,KY,32572,347,2960,253,29612,94,148,4,1059,274,0,155,534,,,1174,A
20200420,LA,136111,763,24523,595,111588,168,1328,32,,1794,0,,,332,,,A
20200420,MA,177462,8347,41416,1596,136046,6751,2303,157,3872,3872,83,987,,,,,B
20200420,MD,71397,3506,13684,854,57713,2652,683,57,3014,,128,,,,,917,A
20200420,ME,14951,8,875,8,14076,0,35,1,138,39,2,16,,9,,414,A
20200420,MI,131887,4572,38494,937,93393,3635,3347,111,,3374,0,1346,,1102,,3237,B
20200420,MN,50044,842,3190,276,46854,566,143,9,602,237,28,126,241,,,1059,A
20200420,MO,56013,2104,5807,140,50206,1964,177,1,,873,0,,,,,,A
20200420,MP,65,9,14,0,51,9,2,0,,,0,,,,,11,
20200420,MS,51434,12369,4512,238,46922,12131,169,10,819,548,11,146,,89,,,A
20200420,MT,11051,153,433,0,10618,153,10,0,57,19,2,,,,,243,A
20200420,NC,79484,712,6764,271,72720,441,179,7,,373,0,,,,,,A
20200420,ND,14747,1117,627,42,14120,1075,13,3,53,17,2,,,,,189,B
20200420,NE,15680,1105,1474,187,14206,918,28,0,,,0,,,,,,A
20200420,NH,14118,694,1392,50,12726,644,41,3,198,79,6,,,,,521,B
20200420,NJ,178057,7369,88806,3505,89251,3864,4377,175,,6986,0,2018,,1594,,,A
20200420,NM,37042,410,1845,47,35197,363,55,2,274,103,16,,,,,487,A
20200420,NV,32347,749,3830,102,28517,647,180,8,,,0,,,,,,A
20200420,NY,633861,16306,247512,4726,386349,11580,14347,478,65969,16103,1419,4814,,,,39085,A
20200420,OH,90839,3540,12919,1317,77920,2223,509,38,2653,,88,,798,,,,B
20200420,OK,35646,81,2680,81,32966,0,143,3,541,307,0,136,,,,1614,B
20200420,OR,40045,1007,1956,46,38089,961,75,1,465,303,9,74,,35,,,A
20200420,PA,162952,4098,33232,948,129720,3150,1204,92,,2701,0,,,659,,,A
20200420,PR,9738,245,1252,39,8486,206,63,1,,151,0,,,,,,A
20200420,RI,36468,1972,5585,378,30883,1594,175,11,629,297,24,62,,45,,267,B
20200420,SC,40480,0,4377,0,36103,0,120,0,776,,0,,,,,2063,B
20200420,SD,12326,264,1685,50,10641,214,7,0,87,,13,,,,,709,A
20200420,TN,100689,3591,7238,168,93451,3423,152,4,730,505,6,,,,,3575,A
20200420,TX,190394,7684,19458,535,170936,7149,495,18,,1411,0,,,,,5706,A
20200420,UT,68311,4756,3213,144,65098,4612,28,1,268,,9,,,,,776,A
20200420,VA,56735,2002,8990,453,47745,1549,300,23,1500,1296,78,396,,237,,1324,A
20200420,VI,607,6,53,0,554,6,3,0,,,0,,,,,48,
20200420,VT,12491,224,820,3,11671,221,38,0,,49,0,,,,,15,A
20200420,WA,161779,4388,13890,307,147889,4081,629,14,,403,0,122,,,,,C
20200420,WI,51956,1457,5353,177,46603,1280,230,10,1211,406,21,168,307,,,,A
20200420,WV,22155,2124,902,39,21253,2085,24,6,,77,0,37,,23,,290,B
20200420,WY,7386,105,313,4,7073,101,2,0,51,19,1,,,,,233,A
20200419,AK,9895,240,319,5,9576,235,9,0,36,37,0,,,,,153,A
20200419,AL,45712,3174,4837,182,40875,2992,154,8,641,,21,,260,,157,,B
20200419,AR,24209,68,1781,42,22428,26,40,2,291,88,0,,,25,57,721,A
20200419,AS,3,0,0,0,3,0,,0,,,0,,,,,,
20200419,AZ,52990,1945,4929,210,48061,1735,184,7,1387,631,46,283,,187,,994,B
20200419,CA,280900,21234,30333,1370,250567,19864,1166,94,,4731,0,1457,,,,,B
20200419,CO,44606,1299,9433,386,35173,913,411,20,1797,874,42,,,,,,A
20200419,CT,58213,2751,17550,741,40663,2010,1086,50,,1938,0,,,,,,A
20200419,DC,13699,431,2793,127,10906,304,96,5,,313,0,105,,79,,622,A
20200419,DE,14794,777,2538,215,12256,562,90,4,,249,0,,,,,466,A
20200419,FL,256079,9552,25996,727,230083,8825,781,27,3930,,88,,,,,,A
20200419,GA,79933,5725,18301,632,61632,5093,687,14,3464,,44,,,,,,A
20200419,GU,1076,0,133,0,943,0,5,0,,6,0,2,,,,112,
20200419,HI,23470,1127,574,21,22896,1106,9,0,51,,3,,,,,410,A
20200419,IA,24550,1603,2902,389,21648,1214,75,1,,198,0,86,,54,,1171,A
20200419,ID,17441,494,1668,13,15773,481,44,1,151,43,0,,53,,,520,A
20200419,IL,143318,5914,30357,1197,112961,4717,1290,31,,4314,0,1196,,749,,,A
20200419,IN,61142,4269,11210,569,49932,3700,562,17,,,0,649,,342,,,B
20200419,KS,18130,454,1849,59,16281,395,92,6,390,,7,,,,,,B
20200419,KY,32225,1629,2707,185,29518,1444,144,7,1059,274,51,155,534,,,1174,A
20200419,LA,135348,-2651,23928,348,111420,-2999,1296,29,,1748,0,,,349,,,A
20200419,MA,169115,6984,39820,2293,129295,4691,2146,163,3789,3789,61,987,,,,,B
20200419,MD,67891,2521,12830,522,55061,1999,626,44,2886,,129,,,,,914,A
20200419,ME,14943,20,867,20,14076,0,34,2,136,46,0,18,,9,,393,A
20200419,MI,127315,3172,37557,528,89758,2644,3236,129,,3403,0,1344,,1115,,3237,B
20200419,MN,49202,1232,2914,126,46288,1106,134,13,574,228,13,116,226,,,1026,A
20200419,MO,53909,150,5667,150,48242,0,176,1,,875,0,,,,,,A
20200419,MP,56,0,14,0,42,0,2,0,,,0,,,,,9,
20200419,MS,39065,300,4274,300,34791,0,159,7,808,,26,138,,79,,,A
20200419,MT,10898,329,433,7,10465,322,10,0,55,18,0,,,,,243,A
20200419,NC,78772,2561,6493,353,72279,2208,172,8,,465,0,,,,,,A
20200419,ND,13630,667,585,57,13045,610,10,1,51,15,4,,,,,189,B
20200419,NE,14575,898,1287,149,13288,749,28,4,,,0,,,,,,A
20200419,NH,13424,572,1342,55,12082,517,38,1,192,85,2,,,,,513,B
20200419,NJ,170688,8152,85301,3881,85387,4271,4202,132,,7494,0,1940,,1628,,,A
20200419,NM,36632,1019,1798,87,34834,932,53,2,258,92,16,,,,,465,A
20200419,NV,31598,847,3728,102,27870,745,172,4,,,0,,,,,,A
20200419,NY,617555,21023,242786,6054,374769,14969,13869,507,64550,16213,1447,4878,,,,37596,A
20200419,OH,87299,8258,11602,1380,75697,6878,471,20,2565,,46,,765,,,,B
20200419,OK,35565,29,2599,29,32966,0,140,1,541,307,0,136,,,,1575,B
20200419,OR,39038,1455,1910,66,37128,1389,74,2,456,290,7,74,,37,,,A
20200419,PA,158854,4889,32284,1215,126570,3674,1112,276,,2634,0,,,657,,,A
20200419,PR,9493,320,1213,95,8280,225,62,2,,160,0,,,,,,A
20200419,RI,34496,2101,5207,339,29289,1762,164,14,605,298,27,66,,37,,244,B
20200419,SC,40480,1647,4377,131,36103,1516,120,1,776,,0,,,,,2633,B
20200419,SD,12062,402,1635,93,10427,309,7,0,74,,6,,,,,646,A
20200419,TN,97098,6512,7070,308,90028,6204,148,3,724,393,5,,,,,3344,A
20200419,TX,182710,6471,18923,663,163787,5808,477,24,,1471,0,,,,,5334,A
20200419,UT,63555,3611,3069,138,60486,3473,27,2,259,,8,,,,,679,A
20200419,VA,54733,2802,8537,484,46196,2318,277,19,1422,1319,126,388,,231,,1267,A
20200419,VI,601,158,53,0,548,158,3,0,,,0,,,,,48,
20200419,VT,12267,242,817,4,11450,238,38,0,,53,0,,,,,15,A
20200419,WA,157391,1677,13583,176,143808,1501,615,17,,586,0,193,,,,,C
20200419,WI,50499,1524,5176,163,45323,1361,220,9,1190,397,14,162,307,,,,A
20200419,WV,20031,591,863,78,19168,513,18,2,,72,0,37,,25,,265,B
20200419,WY,7281,759,309,4,6972,755,2,0,50,19,0,,,,,227,A
20200418,AK,9655,205,314,5,9341,200,9,0,36,39,0,,,,,147,A
20200418,AL,42538,4690,4655,125,37883,4565,146,2,620,,26,,247,,148,,B
20200418,AR,24141,647,1739,44,22402,603,38,1,291,86,291,,,22,57,703,A
20200418,AS,3,0,0,0,3,0,,0,,,0,,,,,,
20200418,AZ,51045,1815,4719,212,46326,1603,177,8,1341,566,52,285,,178,,539,B
20200418,CA,259666,8052,28963,1435,230703,6617,1072,87,,4936,0,1490,,,,,B
20200418,CO,43307,1477,9047,372,34260,1105,391,17,1755,843,62,,,,,,A
20200418,CT,55462,0,16809,0,38653,0,1036,0,,1946,0,,,,,,A
20200418,DC,13268,625,2666,190,10602,435,91,5,,313,0,105,,79,,608,A
20200418,DE,14017,0,2323,0,11694,0,86,10,,224,0,,,,,423,A
20200418,FL,246527,11690,25269,1150,221258,10540,754,55,3842,,177,,,,,,A
20200418,GA,74208,2524,17669,475,56539,2049,673,23,3420,,96,,,,,,A
20200418,GU,1076,3,133,0,943,3,5,0,,6,0,2,,,,110,
20200418,HI,22343,486,553,12,21790,474,9,0,48,,3,,,,,390,A
20200418,IA,22947,1155,2513,181,20434,974,74,10,,193,0,84,,51,,1095,A
20200418,ID,16947,295,1655,46,15292,249,43,2,151,53,3,,53,,,453,A
20200418,IL,137404,7241,29160,1585,108244,5656,1259,125,,4340,0,1192,,740,,,A
20200418,IN,56873,2088,10641,487,46232,1601,545,26,,,0,663,,360,,,B
20200418,KS,17676,775,1790,85,15886,690,86,2,383,,8,,,,,,B
20200418,KY,30596,849,2522,93,28074,756,137,8,1008,360,37,227,514,,,979,A
20200418,LA,137999,6012,23580,462,114419,5550,1267,54,,1761,0,,,347,,,A
20200418,MA,162131,9811,37527,2402,124604,7409,1983,161,3728,3728,-28,987,,,,,B
20200418,MD,65370,3361,12308,736,53062,2625,582,41,2757,,145,,,,,771,A
20200418,ME,14923,20,847,20,14076,0,32,3,136,49,3,20,,12,,382,A
20200418,MI,124143,4555,37029,709,87114,3846,3107,123,,3634,0,1423,,1203,,3237,B
20200418,MN,47970,1482,2788,120,45182,1362,121,10,561,239,43,111,215,,,997,A
20200418,MO,53759,2042,5517,234,48242,1808,175,10,,875,0,,,,,,A
20200418,MP,56,1,14,1,42,0,2,0,,,0,,,,,9,
20200418,MS,38765,181,3974,181,34791,0,152,12,782,,46,154,,99,,,A
20200418,MT,10569,325,426,4,10143,321,10,2,55,17,1,,,,,234,A
20200418,NC,76211,3230,6140,281,70071,2949,164,12,,388,0,,,,,,A
20200418,ND,12963,621,528,89,12435,532,9,0,47,13,0,,,,,183,B
20200418,NE,13677,573,1138,72,12539,501,24,0,,,0,,,,,,A
20200418,NH,12852,144,1287,0,11565,144,37,0,190,86,0,,,,,468,B
20200418,NJ,162536,5087,81420,2953,81116,2134,4070,230,,7718,0,2024,,1641,,,A
20200418,NM,35613,1125,1711,114,33902,1011,51,7,242,96,12,,,,,382,A
20200418,NV,30751,989,3626,102,27125,887,168,6,,,0,,,,,,A
20200418,NY,596532,23309,236732,7090,359800,16219,13362,540,63103,16967,1983,4996,,,,35458,A
20200418,OH,79041,1115,10222,1115,68819,0,451,33,2519,,95,,760,,,,B
20200418,OK,35536,1916,2570,105,32966,1811,139,3,541,307,13,136,,,,1515,B
20200418,OR,37583,1262,1844,59,35739,1203,72,2,449,290,22,74,,37,,,A
20200418,PA,153965,6592,31069,1628,122896,4964,836,80,,2613,0,,,660,,,A
20200418,PR,9173,241,1118,50,8055,191,60,2,,165,0,,,,,,A
20200418,RI,32395,1653,4868,283,27527,1370,150,32,578,293,247,67,,43,,217,B
20200418,SC,38833,2549,4246,315,34587,2234,119,10,776,,101,,,,,2633,B
20200418,SD,11660,598,1542,131,10118,467,7,0,68,,5,,,,,552,A
20200418,TN,90586,3313,6762,173,83824,3140,145,3,719,593,8,,,,,3234,A
20200418,TX,176239,6703,18260,889,157979,5814,453,25,,1321,0,,,,,4806,A
20200418,UT,59944,4173,2931,126,57013,4047,25,2,251,,7,,,,,565,A
20200418,VA,51931,2934,8053,562,43878,2372,258,27,1296,1307,75,398,,230,,1228,A
20200418,VI,443,19,53,2,390,17,3,1,,,0,,,,,46,
20200418,VT,12025,410,813,11,11212,399,38,3,,56,0,,,,,15,A
20200418,WA,155714,2246,13407,233,142307,2013,598,13,,518,0,155,,,,,C
20200418,WI,48975,1771,5013,174,43962,1597,211,6,1176,361,23,135,307,,,,A
20200418,WV,19440,759,785,31,18655,728,16,3,,83,0,40,,27,,255,B
20200418,WY,6522,95,305,9,6217,86,2,0,50,19,7,,,,,206,A
20200417,AK,9450,715,309,9,9141,706,9,0,36,,1,,,,,128,A
20200417,AL,37848,1457,4530,185,33318,1272,144,11,594,,41,,247,,148,,B
20200417,AR,23494,819,1695,75,21799,744,37,0,,83,0,,,21,,593,A
20200417,AS,3,0,0,0,3,0,,0,,,0,,,,,,
20200417,AZ,49230,1832,4507,273,44723,1559,169,19,1289,566,31,285,,178,,539,B
20200417,CA,251614,5214,27528,1346,224086,3868,985,95,,4892,0,1484,,,,,B
20200417,CO,41830,1297,8675,395,33155,902,374,17,1693,858,57,,,,,,A
20200417,CT,55462,2340,16809,925,38653,1415,1036,65,,1946,0,,,,,,A
20200417,DC,12643,493,2476,126,10167,367,86,5,,313,0,105,,79,,573,A
20200417,DE,14017,667,2323,248,11694,419,76,6,,224,0,,,,,423,A
20200417,FL,234837,15589,24119,1222,210718,14367,699,53,3665,,205,,,,,,A
20200417,GA,71684,3745,17194,1525,54490,2220,650,63,3324,,216,,,,,,A
20200417,GU,1073,70,133,0,940,70,5,0,,6,0,2,,,,97,
20200417,HI,21857,1157,541,11,21316,1146,9,0,45,,0,,,,,374,A
20200417,IA,21792,1117,2332,191,19460,926,64,4,,183,0,88,,52,,1007,A
20200417,ID,16652,410,1609,22,15043,388,41,0,148,58,5,,51,,,390,A
20200417,IL,130163,7574,27575,1842,102588,5732,1134,62,,4454,0,1196,,777,,,A
20200417,IN,54785,3670,10154,612,44631,3058,519,42,,,0,638,,417,,,B
20200417,KS,16901,779,1705,117,15196,662,84,4,375,,16,,,,,,B
20200417,KY,29747,1423,2429,138,27318,1285,129,7,971,477,164,333,506,,,956,A
20200417,LA,131987,5401,23118,586,108869,4815,1213,57,,1868,0,,,363,,,A
20200417,MA,152320,9730,35125,2633,117195,7097,1822,155,3756,3756,30,987,,,,,B
20200417,MD,62009,3166,11572,788,50437,2378,541,42,2612,,161,,,,,736,A
20200417,ME,14903,31,827,31,14076,0,29,2,133,55,3,28,,8,,352,A
20200417,MI,119588,5859,36320,865,83268,4994,2984,143,,3674,0,1428,,1167,,629,B
20200417,MN,46488,1466,2668,182,43820,1284,111,17,518,223,43,106,202,,,955,A
20200417,MO,51717,1069,5283,172,46434,897,165,13,,1043,0,,,,,,A
20200417,MP,55,15,13,0,42,15,2,0,,,0,,,,,,
20200417,MS,38584,169,3793,169,34791,0,140,11,736,,54,154,,99,,,A
20200417,MT,10244,308,422,7,9822,301,8,1,54,21,2,,,,,233,A
20200417,NC,72981,2064,5859,394,67122,1670,152,21,,429,0,,,,,,A
20200417,ND,12342,638,439,46,11903,592,9,0,47,16,2,,,,,172,B
20200417,NE,13104,810,1066,114,12038,696,24,3,,,0,,,,,,A
20200417,NH,12708,542,1287,148,11421,394,37,5,190,74,12,,,,,455,B
20200417,NJ,157449,5619,78467,3150,78982,2469,3840,322,,8011,0,1961,,1594,,,A
20200417,NM,34488,1094,1597,113,32891,981,44,8,230,90,15,,,,,353,A
20200417,NV,29762,1311,3524,203,26238,1108,162,4,,,0,,,,,,A
20200417,NY,573223,22644,229642,7358,343581,15286,12822,630,61120,17316,2068,5039,,,,33392,A
20200417,OH,77926,3086,9107,693,68819,2393,418,29,2424,,93,,740,,,,B
20200417,OK,33620,2721,2465,108,31155,2613,136,5,528,325,0,155,,,,1331,B
20200417,OR,36321,1383,1785,49,34536,1334,70,6,427,301,13,69,,41,,,A
20200417,PA,147373,5903,29441,1706,117932,4197,756,49,,2603,0,,,661,,,A
20200417,PR,8932,574,1068,25,7864,549,58,2,,,0,,,,,,A
20200417,RI,30742,1790,4585,290,26157,1500,118,13,331,252,0,62,,43,,196,B
20200417,SC,36284,1551,3931,275,32353,1276,109,2,675,,0,,,,,,B
20200417,SD,11062,512,1411,100,9651,412,7,0,63,,8,,,,,457,A
20200417,TN,87273,2224,6589,327,80684,1897,142,1,711,465,20,,,,,3017,A
20200417,TX,169536,10989,17371,916,152165,10073,428,35,,1522,0,,,,,4190,A
20200417,UT,55771,6093,2805,122,52966,5971,23,2,244,,6,,,,,443,A
20200417,VA,48997,2553,7491,602,41506,1951,231,23,1221,1308,107,400,,224,,1110,A
20200417,VI,424,16,51,0,373,16,2,1,,,0,,,,,46,
20200417,VT,11615,564,802,10,10813,554,35,0,,32,0,,,,,15,A
20200417,WA,153468,4452,13174,302,140294,4150,585,14,,622,0,195,,,,,C
20200417,WI,47204,1594,4839,203,42365,1391,205,8,1153,361,32,141,306,348,,,A
20200417,WV,18681,375,754,15,17927,360,13,0,,85,0,34,,24,,223,B
20200417,WY,6427,0,296,0,6131,0,2,0,43,19,0,,,,,148,A
20200416,AK,8735,71,300,7,8435,64,9,0,35,,1,,,,,110,A
20200416,AL,36391,2314,4345,232,32046,2082,133,12,553,,28,,227,,137,,B
20200416,AR,22675,841,1620,51,21055,790,37,4,,85,-130,,,21,,548,A
20200416,AS,3,0,0,0,3,0,,0,,,0,,,,,,
20200416,AZ,47398,2088,4234,272,43164,1816,150,8,1258,578,45,278,,188,,460,B
20200416,CA,246400,29914,26182,1758,220218,28156,890,69,,5031,0,1568,,,,,B
20200416,CO,40533,953,8280,339,32253,614,357,28,1636,859,80,,,,,,A
20200416,CT,53122,2979,15884,1129,37238,1850,971,103,,1926,0,,,,,,A
20200416,DC,12150,625,2350,153,9800,472,81,9,,313,0,105,,79,,552,A
20200416,DE,13350,248,2075,61,11275,187,70,3,,209,0,,,,,378,A
20200416,FL,219248,5739,22897,386,196351,5353,646,37,3460,,116,,,,,,A
20200416,GA,67939,3849,15669,682,52270,3167,587,35,3108,,186,,,,,,A
20200416,GU,1003,27,133,0,870,27,5,0,,9,0,,,,,86,
20200416,HI,20700,897,530,13,20170,884,9,0,45,,0,,,,,359,A
20200416,IA,20675,806,2141,146,18534,660,60,7,,175,0,84,,48,,987,A
20200416,ID,16242,844,1587,123,14655,721,41,2,143,70,2,,46,,,,A
20200416,IL,122589,5660,25733,1140,96856,4520,1072,124,,4423,0,1248,,797,,,A
20200416,IN,51115,2719,9542,587,41573,2132,477,41,,,0,696,,426,,,B
20200416,KS,16122,1454,1588,94,14534,1360,80,4,359,,17,,,,,,B
20200416,KY,28324,627,2291,81,26033,546,122,7,807,412,120,252,367,,,862,A
20200416,LA,126586,4658,22532,581,104054,4077,1156,53,,1914,0,,,396,,,A
20200416,MA,142590,9830,32492,2522,110098,7308,1667,165,3726,3726,89,973,,,,,B
20200416,MD,58843,3080,10784,752,48059,2328,499,30,2451,,220,,,,,736,A
20200416,ME,14872,26,796,26,14076,0,27,3,130,47,4,20,,7,,333,A
20200416,MI,113729,5368,35455,922,78274,4446,2841,169,,3809,0,1447,,1211,,617,B
20200416,MN,45022,1456,2486,165,42536,1291,94,7,475,213,30,103,188,,,926,A
20200416,MO,50648,1636,5111,216,45537,1420,152,5,,1043,0,,,,,,A
20200416,MP,40,0,13,0,27,0,2,0,,,0,,,,,,
20200416,MS,38415,264,3624,264,34791,0,129,7,682,,37,154,,99,,,A
20200416,MT,9936,353,415,11,9521,342,7,0,52,21,1,,,,,218,A
20200416,NC,70917,3090,5465,342,65452,2748,131,14,,452,0,,,,,,A
20200416,ND,11704,387,393,28,11311,359,9,0,45,14,1,,,,,163,B
20200416,NE,12294,565,952,51,11342,514,21,1,,,0,,,,,,A
20200416,NH,12166,0,1139,0,11027,0,32,0,178,70,0,,,,,365,B
20200416,NJ,151830,7809,75317,4287,76513,3522,3518,362,,8224,0,2014,,1645,,,A
20200416,NM,33394,544,1484,77,31910,467,36,0,215,90,34,,,,,353,A
20200416,NV,28451,796,3321,110,25130,686,158,8,,,0,,,,,,A
20200416,NY,550579,24567,222284,8505,328295,16062,12192,606,59052,17735,2084,5071,,,,30800,A
20200416,OH,74840,3288,8414,623,66426,2665,389,28,2331,,94,,707,,,,B
20200416,OK,30899,1680,2357,94,28542,1586,131,8,528,236,18,163,,,,1240,B
20200416,OR,34938,1587,1736,73,33202,1514,64,6,414,307,13,89,,43,,,A
20200416,PA,141470,3886,27735,1245,113735,2641,707,60,,2512,0,,,675,,,A
20200416,PR,8358,559,1043,69,7315,490,56,5,,,0,,,,,,A
20200416,RI,28952,2482,4295,392,24657,2090,105,18,331,245,0,61,,43,,182,B
20200416,SC,34733,0,3656,0,31077,0,107,0,675,,0,,,,,,B
20200416,SD,10550,691,1311,143,9239,548,7,1,55,,4,,,,,373,A
20200416,TN,85049,4153,6262,183,78787,3970,141,6,691,444,28,,,,,2786,A
20200416,TX,158547,6737,16455,963,142092,5774,393,29,,1459,0,,,,,3677,A
20200416,UT,49678,2064,2683,141,46995,1923,21,1,238,,17,,,,,357,A
20200416,VA,46444,2275,6889,389,39555,1886,208,13,1114,1337,66,427,,238,,951,A
20200416,VI,408,26,51,0,357,26,1,0,,,0,,,,,46,
20200416,VT,11051,359,792,13,10259,346,35,5,,58,0,,,,,15,A
20200416,WA,149016,4348,12872,253,136144,4095,571,20,,595,0,196,,,,,C
20200416,WI,45610,1831,4636,183,40974,1648,197,15,1121,394,30,147,299,,,,A
20200416,WV,18306,650,739,37,17567,613,13,3,,85,-164,34,,24,,223,B
20200416,WY,6427,98,296,9,6131,89,2,0,43,19,0,,,,,148,A
20200415,AK,8664,316,293,8,8371,308,9,0,34,,2,,,,,106,A
20200415,AL,34077,960,4113,237,29964,723,121,11,525,,32,,219,,134,,B
20200415,AR,21834,703,1569,89,20265,614,33,3,130,83,0,,43,26,39,489,A
20200415,AS,3,0,0,0,3,0,,0,,,0,,,,,,
20200415,AZ,45310,1214,3962,156,41348,1058,142,11,1213,590,42,286,,202,,385,B
20200415,CA,216486,14278,24424,1086,192062,13192,821,63,,5163,0,1175,,,,,B
20200415,CO,39580,838,7941,250,31639,588,329,21,1556,878,63,,,,,,A
20200415,CT,50143,4302,14755,766,35388,3536,868,197,,1908,0,,,,,,A
20200415,DC,11525,241,2197,139,9328,102,72,5,,313,0,105,,79,,530,A
20200415,DE,13102,798,2014,253,11088,545,67,7,,208,0,,,,,354,A
20200415,FL,213509,10329,22511,1144,190998,9185,609,72,3344,,284,,,,,,A
20200415,GA,64090,2295,14987,764,49103,1531,552,51,2922,,153,,,,,,A
20200415,GU,976,32,133,0,843,32,5,0,,9,0,2,,2,,73,
20200415,HI,19803,383,517,13,19286,370,9,0,45,,1,,,,,333,A
20200415,IA,19869,984,1995,96,17874,888,53,4,,171,0,78,,43,,908,A
20200415,ID,15398,284,1464,11,13934,273,39,6,141,66,6,,43,,,,A
20200415,IL,116929,6313,24593,1346,92336,4967,948,80,,4283,0,1189,,796,,,A
20200415,IN,48396,2379,8955,428,39441,1951,436,48,,,0,737,,422,,,B
20200415,KS,14668,521,1494,68,13174,453,76,7,342,,15,,,,,,B
20200415,KY,27697,1014,2210,162,25487,852,115,11,687,305,14,137,263,,,653,A
20200415,LA,121928,3506,21951,433,99977,3073,1103,90,,1943,0,,,425,,,A
20200415,MA,132760,5831,29970,1861,102790,3970,1502,173,3637,3637,21,973,,,,,B
20200415,MD,55763,2030,10032,560,45731,1470,469,48,2231,,109,,,,,607,A
20200415,ME,14846,2504,770,36,14076,2468,24,4,126,48,2,22,,9,,305,A
20200415,MI,108361,4073,34533,920,73828,3153,2672,140,,3918,0,1468,,1212,,452,B
20200415,MN,43566,1696,2321,156,41245,1540,87,8,445,197,40,93,175,,,853,A
20200415,MO,49012,1034,4895,209,44117,825,147,14,,1024,0,,,,,,A
20200415,MP,40,0,13,0,27,0,2,0,,,0,,,,,,
20200415,MS,38151,273,3360,273,34791,0,122,11,645,,49,154,,99,,,A
20200415,MT,9583,349,404,5,9179,344,7,0,51,21,1,,,,,209,A
20200415,NC,67827,2788,5123,99,62704,2689,117,9,,431,0,,,,,,A
20200415,ND,11317,401,365,24,10952,377,9,0,44,13,2,,,,,142,B
20200415,NE,11729,372,901,30,10828,342,20,2,,,0,,,,,,A
20200415,NH,12166,556,1139,119,11027,437,32,9,178,70,26,,,,,365,B
20200415,NJ,144021,4247,71030,2206,72991,2041,3156,351,,8270,0,1980,,1705,,,A
20200415,NM,32850,880,1407,62,31443,818,36,5,181,87,0,,,,,340,A
20200415,NV,27655,994,3211,123,24444,871,150,9,,,0,,,,,,A
20200415,NY,526012,26869,213779,11571,312233,15298,11586,752,56968,18335,2315,5205,,,,28004,A
20200415,OH,71552,3551,7791,511,63761,3040,361,37,2237,,81,,677,,,,B
20200415,OK,29219,950,2263,79,26956,871,123,15,510,194,22,107,,,,1115,B
20200415,OR,33351,988,1663,30,31688,958,58,3,401,305,20,95,,43,,,A
20200415,PA,137584,3953,26490,1145,111094,2808,647,63,,2395,0,,,668,,,A
20200415,PR,7799,592,974,51,6825,541,51,6,,,0,,,,,,A
20200415,RI,26470,1884,3903,307,22567,1577,87,7,331,229,0,54,,44,,168,B
20200415,SC,34733,861,3656,103,31077,758,107,10,675,,0,,,,,,B
20200415,SD,9859,563,1168,180,8691,383,6,0,51,,6,,,,,329,A
20200415,TN,80896,2065,6079,256,74817,1809,135,11,663,412,30,,,,,2196,A
20200415,TX,151810,5343,15492,868,136318,4475,364,46,,1538,0,,,,,3150,A
20200415,UT,47614,1138,2542,130,45072,1008,20,1,221,,8,,,,,218,A
20200415,VA,44169,1406,6500,329,37669,1077,195,41,1048,1298,1048,394,,234,,752,A
20200415,VI,382,5,51,0,331,5,1,0,,,0,,,,,44,
20200415,VT,10692,431,779,9,9913,422,30,1,,63,0,,,,,15,A
20200415,WA,144668,4146,12619,316,132049,3830,551,9,,645,0,194,,,,,C
20200415,WI,43779,1536,4453,207,39326,1329,182,12,1091,406,42,163,290,,,,A
20200415,WV,17656,618,702,62,16954,556,10,1,164,82,0,36,73,23,50,211,B
20200415,WY,6329,365,287,12,6042,353,2,1,43,,0,,,,,129,A
20200414,AK,8348,518,285,8,8063,510,9,1,32,,0,,,,,98,A
20200414,AL,33117,3935,3876,142,29241,3793,110,11,493,,36,,210,,132,,B
20200414,AR,21131,327,1480,70,19651,257,30,0,130,81,0,,43,29,39,427,A
20200414,AS,3,0,0,0,3,0,,0,,,0,,,,,,
20200414,AZ,44096,749,3806,104,40290,645,131,9,1171,580,49,286,,216,,249,B
20200414,CA,202208,11326,23338,990,178870,10336,758,71,,5163,0,1552,,,,,B
20200414,CO,38742,1208,7691,7,31051,1201,308,4,1493,888,21,,,,,,A
20200414,CT,45841,1532,13989,608,31852,924,671,69,,1779,0,,,,,,A
20200414,DC,11284,350,2058,103,9226,247,67,14,,295,0,95,,31,,518,A
20200414,DE,12304,484,1761,136,10543,348,60,7,,204,0,,,,,277,A
20200414,FL,203180,6973,21367,766,181813,6207,537,54,3060,,227,,,,,,A
20200414,GA,61795,4774,14223,908,47572,3866,501,37,2769,,180,,,,,,A
20200414,GU,944,41,133,0,811,41,5,0,,13,0,2,,2,,66,
20200414,HI,19420,576,504,5,18916,571,9,0,44,,0,,,,,315,A
20200414,IA,18885,189,1899,189,16986,0,49,6,,163,0,73,,41,,741,A
20200414,ID,15114,233,1453,27,13661,206,33,6,135,59,3,,38,,,,A
20200414,IL,110616,4848,23247,1222,87369,3626,868,74,,4283,0,1189,,796,,,A
20200414,IN,46017,1478,8527,291,37490,1187,388,38,,,0,721,,435,,,B
20200414,KS,14147,283,1426,50,12721,233,69,7,327,,18,,,,,,B
20200414,KY,26683,817,2048,85,24635,732,104,7,673,299,6,136,259,,,629,A
20200414,LA,118422,10331,21518,502,96904,9829,1013,129,,1977,0,,,436,,,A
20200414,MA,126929,4635,28109,1315,98820,3320,1329,118,3616,3616,131,,,,,,B
20200414,MD,53733,1982,9472,536,44261,1446,421,37,2122,,147,,,,,607,A
20200414,ME,12342,36,734,36,11608,0,20,1,124,58,0,21,,9,,292,A
20200414,MI,104288,4523,33613,911,70675,3612,2532,141,,3910,0,1497,,1235,,452,B
20200414,MN,41870,1191,2165,153,39705,1038,79,9,405,177,44,75,155,,,830,A
20200414,MO,47978,2550,4686,298,43292,2252,133,19,,1041,0,,,,,,A
20200414,MP,40,2,13,2,27,0,2,0,,,0,,,,,,
20200414,MS,37878,6894,3087,145,34791,6749,111,13,596,,47,154,,99,,,A
20200414,MT,9234,136,399,5,8835,131,7,0,50,24,3,,,,,197,A
20200414,NC,65039,1651,5024,208,60015,1443,108,22,,418,0,,,,,,A
20200414,ND,10916,135,341,10,10575,125,9,1,42,13,2,,,,,138,B
20200414,NE,11357,385,871,57,10486,328,18,1,,,0,,,,,,A
20200414,NH,11610,403,1020,35,10590,368,23,0,152,72,0,,,,,249,B
20200414,NJ,139774,10305,68824,4240,70950,6065,2805,362,,8185,0,2051,,1626,,,A
20200414,NM,31970,1455,1345,100,30625,1355,31,5,181,87,181,,,,,304,A
20200414,NV,26661,1197,3088,117,23573,1080,141,8,,,0,,,,,,A
20200414,NY,499143,20786,202208,7177,296935,13609,10834,778,54653,18697,1717,5225,,,,25589,A
20200414,OH,68001,2889,7280,305,60721,2584,324,50,2156,,123,,654,,,,B
20200414,OK,28269,5410,2184,115,26085,5295,108,9,488,194,31,107,,,,1060,B
20200414,OR,32363,1242,1633,49,30730,1193,55,2,381,311,12,88,,44,,,A
20200414,PA,133631,3839,25345,1146,108286,2693,584,60,,2317,0,,,675,,,A
20200414,PR,7207,344,923,20,6284,324,45,0,,,0,,,,,,A
20200414,RI,24586,1826,3596,267,20990,1559,80,7,331,213,0,48,,,,135,B
20200414,SC,33872,2447,3553,234,30319,2213,97,15,675,,179,,,,,,B
20200414,SD,9296,294,988,120,8308,174,6,0,45,,1,,,,,261,A
20200414,TN,78831,2636,5823,213,73008,2423,124,15,633,443,54,,,,,1969,A
20200414,TX,146467,13241,14624,718,131843,12523,318,31,,1409,0,,,,,2580,A
20200414,UT,46476,689,2412,49,44064,640,19,1,213,,12,,,,,218,A
20200414,VA,42763,1362,6171,424,36592,938,154,5,,1282,0,422,,276,,721,A
20200414,VI,377,4,51,0,326,4,1,0,,,0,,,,,44,
20200414,VT,10261,225,770,9,9491,216,29,1,,64,0,,,,,15,A
20200414,WA,140522,4309,12303,224,128219,4085,542,16,,387,0,98,,,,,C
20200414,WI,42243,1394,4246,166,37997,1228,170,16,1049,432,56,161,283,,,,A
20200414,WV,17038,383,640,14,16398,369,9,0,164,87,0,38,73,25,50,147,B
20200414,WY,5964,0,275,0,5689,0,1,0,43,,2,,,,,140,A
20200413,AK,7830,-208,277,5,7553,-213,8,0,32,,1,,,,,85,A
20200413,AL,29182,7599,3734,209,25448,7390,99,6,457,,20,,189,,119,,B
20200413,AR,20804,1082,1410,130,19394,952,30,3,130,74,0,,43,28,39,391,A
20200413,AS,3,0,0,0,3,0,,0,,,0,,,,,,
20200413,AZ,43347,1238,3702,163,39645,1075,122,7,1122,525,48,286,,195,,,B
20200413,CA,190882,554,22348,554,168534,0,687,36,,3015,0,1178,,,,,B
20200413,CO,37534,2661,7684,791,29850,1870,304,30,1472,842,96,,,,,,A
20200413,CT,44309,3089,13381,1346,30928,1743,602,48,,1760,0,,,,,,A
20200413,DC,10934,294,1955,80,8979,214,53,3,,295,0,95,,31,,507,A
20200413,DE,11820,717,1625,146,10195,571,53,5,,201,0,,,,,213,A
20200413,FL,196207,13454,20601,1246,175606,12208,483,18,2833,,61,,,,,,A
20200413,GA,57021,2568,13315,863,43706,1705,464,31,2589,,84,,,,,,A
20200413,GU,903,77,133,0,770,77,5,0,,12,0,2,,2,,58,
20200413,HI,18844,876,499,13,18345,863,9,1,44,,0,,6,,2,310,A
20200413,IA,18696,1104,1710,123,16986,981,43,2,,142,0,70,,41,,741,A
20200413,ID,14881,573,1426,19,13455,554,27,0,132,62,1,,38,,,,A
20200413,IL,105768,5033,22025,1173,83743,3860,794,74,,3680,0,1166,,821,,,A
20200413,IN,44539,2050,8236,308,36303,1742,350,7,,,0,740,,459,,,B
20200413,KS,13864,611,1376,39,12488,572,62,6,309,,11,,,,,,B
20200413,KY,25866,1299,1963,123,23903,1176,97,3,667,289,208,136,256,,,607,A
20200413,LA,108091,4046,21016,421,87075,3625,884,44,,2134,0,,,461,,,A
20200413,MA,122294,5450,26794,1413,95500,4037,1211,155,3485,3485,971,,,,,,B
20200413,MD,51751,1987,8936,711,42815,1276,384,49,1975,,115,,,,,603,A
20200413,ME,12306,5585,698,65,11608,5520,19,0,124,22,4,,,,,273,A
20200413,MI,99765,3544,32702,1036,67063,2508,2391,142,,3986,0,1570,,1365,,447,B
20200413,MN,40679,785,2012,148,38667,637,70,0,361,157,0,74,146,,,772,A
20200413,MO,45428,228,4388,228,41040,0,114,4,,988,0,,,,,,A
20200413,MP,38,0,11,0,27,0,2,0,,,0,,,,,,
20200413,MS,30984,9571,2942,161,28042,9410,98,2,549,,1,124,,84,,,A
20200413,MT,9098,185,394,7,8704,178,7,1,47,21,0,,,,,171,A
20200413,NC,63388,1249,4816,296,58572,953,86,5,,313,0,,,,,,A
20200413,ND,10781,431,331,23,10450,408,8,0,40,13,1,,,,,127,B
20200413,NE,10972,281,814,23,10158,258,17,0,,,0,,,,,,A
20200413,NH,11207,282,985,56,10222,226,23,0,152,,6,,,,,239,B
20200413,NJ,129469,2734,64584,2734,64885,0,2443,93,,7781,0,1886,,1611,,,A
20200413,NM,30515,1823,1245,71,29270,1752,26,6,,80,0,,,,,295,A
20200413,NV,25464,853,2971,135,22493,718,133,5,,,0,,,,,,A
20200413,NY,478357,16756,195031,6337,283326,10419,10056,671,52936,18825,2017,5156,,,,23887,A
20200413,OH,65112,1869,6975,371,58137,1498,274,21,2033,,85,,613,,,,B
20200413,OK,22859,99,2069,99,20790,0,99,3,457,383,11,191,,,,865,B
20200413,OR,31121,1363,1584,57,29537,1306,53,1,369,321,10,96,,50,,,A
20200413,PA,129792,4902,24199,1366,105593,3536,524,17,,2243,0,,,669,,,A
20200413,PR,6863,147,903,6,5960,141,45,1,,,0,,,,,,A
20200413,RI,22760,1040,3329,187,19431,853,73,10,331,197,331,50,,26,,135,B
20200413,SC,31425,0,3319,0,28106,0,82,0,496,,0,,,,,,B
20200413,SD,9002,449,868,138,8134,311,6,0,44,,1,,,,,207,A
20200413,TN,76195,5518,5610,302,70585,5216,109,8,579,458,12,,,,,1671,A
20200413,TX,133226,8693,13906,422,119320,8271,287,16,,1176,0,,,,,2269,A
20200413,UT,45787,1553,2363,60,43424,1493,18,0,201,,6,,,,,218,A
20200413,VA,41401,1416,5747,473,35654,943,149,8,,1238,0,428,,302,,,A
20200413,VI,373,23,51,0,322,23,1,0,,,0,,,,,43,
20200413,VT,10036,558,761,7,9275,551,28,1,,33,0,,,,,15,A
20200413,WA,136213,4220,12079,304,124134,3916,526,17,,527,0,166,,,,,C
20200413,WI,40849,969,4080,116,36769,853,154,10,993,442,19,175,264,,,,A
20200413,WV,16655,398,626,15,16029,383,9,1,164,95,164,43,73,23,50,85,B
20200413,WY,5964,505,275,14,5689,491,1,1,41,,1,,,,,138,A
20200412,AK,8038,306,272,15,7766,291,8,0,31,,0,,,,,66,A
20200412,AL,21583,334,3525,334,18058,0,93,2,437,,35,,189,,119,,B
20200412,AR,19722,1144,1280,54,18442,1090,27,3,130,74,0,,43,30,39,367,A
20200412,AS,3,0,0,0,3,0,,0,,,0,,,,,,
20200412,AZ,42109,1579,3539,146,38570,1433,115,7,1074,,37,,,,,,B
20200412,CA,190328,17109,21794,1179,168534,15930,651,42,,5234,0,1539,,,,,B
20200412,CO,34873,2220,6893,383,27980,1837,274,24,1376,822,64,,,,,,A
20200412,CT,41220,1389,12035,525,29185,864,554,60,,1654,0,,,,,,A
20200412,DC,10640,601,1875,97,8765,504,50,3,,,0,,,,,493,A
20200412,DE,11103,0,1479,0,9624,0,48,5,,190,0,,,,,191,A
20200412,FL,182753,9820,19355,861,163398,8959,465,27,2772,,111,,,,,,A
20200412,GA,54453,2738,12452,293,42001,2445,433,5,2505,,26,,,,,,A
20200412,GU,826,0,133,0,693,0,5,0,,13,0,2,,2,,58,
20200412,HI,17968,437,486,21,17482,416,8,0,44,,1,,6,,2,300,A
20200412,IA,17592,460,1587,77,16005,383,41,7,,129,0,55,,30,,674,A
20200412,ID,14308,544,1407,11,12901,533,27,2,131,63,3,,38,,,,A
20200412,IL,100735,8586,20852,1672,79883,6914,720,43,,3680,0,1166,,821,,,A
20200412,IN,42489,3274,7928,493,34561,2781,343,13,,,0,820,,497,,,B
20200412,KS,13253,910,1337,69,11916,841,56,1,298,,5,,,,,,B
20200412,KY,24567,279,1840,147,22727,132,94,4,459,271,0,105,177,,,464,A
20200412,LA,104045,7130,20595,581,83450,6549,840,34,,2084,0,,,458,,,A
20200412,MA,116844,7963,25381,2615,91463,5348,1056,110,2514,2514,7,,,,,,B
20200412,MD,49764,2526,8225,531,41539,1995,335,37,1860,,151,,,,,456,A
20200412,ME,6721,17,633,17,6088,0,19,0,120,,6,,,,,266,A
20200412,MI,96221,3000,31666,686,64555,2314,2249,168,,3636,0,1582,,1441,,433,B
20200412,MN,39894,1190,1864,58,38030,1132,70,6,361,157,21,74,146,,,772,A
20200412,MO,45200,2028,4160,136,41040,1892,110,1,,988,0,,,,,,A
20200412,MP,38,0,11,0,27,0,2,0,,,0,,,,,,
20200412,MS,21413,139,2781,139,18632,0,96,3,548,,20,,,,,,A
20200412,MT,8913,332,387,10,8526,322,6,0,47,22,1,,,,,169,A
20200412,NC,62139,1746,4520,208,57619,1538,81,1,,331,0,,,,,,A
20200412,ND,10350,270,308,15,10042,255,8,1,39,12,3,,,,,121,B
20200412,NE,10691,706,791,91,9900,615,17,0,,,0,,,,,,A
20200412,NH,10925,432,929,44,9996,388,23,1,146,,12,,,,,236,B
20200412,NJ,126735,6542,61850,3699,64885,2843,2350,167,,7604,0,1914,,1644,,,A
20200412,NM,28692,1594,1174,83,27518,1511,20,1,,78,0,,,18,,235,A
20200412,NV,24611,1024,2836,136,21775,888,128,3,,282,0,,,,,,A
20200412,NY,461601,20621,188694,8236,272907,12385,9385,758,50919,18707,2622,5198,,,,23887,A
20200412,OH,63243,2772,6604,354,56639,2418,253,6,1948,,89,,595,,,,B
20200412,OK,22760,102,1970,102,20790,0,96,2,446,383,0,191,,,,865,B
20200412,OR,29758,2534,1527,156,28231,2378,52,4,359,295,21,81,,52,,,A
20200412,PA,124890,4737,22833,1178,102057,3559,507,13,,2097,0,,,649,,,A
20200412,PR,6716,345,897,109,5819,236,44,2,,,0,,,,,,A
20200412,RI,21720,1737,3142,289,18578,1448,63,7,,201,0,50,,26,,35,B
20200412,SC,31425,1332,3319,112,28106,1220,82,2,496,,0,,,,,,B
20200412,SD,8553,549,730,104,7823,445,6,0,43,,10,,,,,197,A
20200412,TN,70677,3849,5308,194,65369,3655,101,0,567,324,11,,,,,1504,A
20200412,TX,124533,4000,13484,923,111049,3077,271,17,,1338,0,,,,,2014,A
20200412,UT,44234,1688,2303,97,41931,1591,18,0,195,,5,,,,,,A
20200412,VA,39985,1986,5274,197,34711,1789,141,11,,751,0,440,,294,,,A
20200412,VI,350,0,51,0,299,0,1,0,,3,0,,,,,43,
20200412,VT,9478,682,754,21,8724,661,27,2,,34,0,,,,,15,A
20200412,WA,131993,1431,11775,170,120218,1261,509,15,,642,0,191,,,,,C
20200412,WI,39880,1378,3964,142,35916,1236,144,7,974,442,24,179,261,,,,A
20200412,WV,16257,805,611,34,15646,771,8,3,,81,0,36,,24,,83,B
20200412,WY,5459,0,261,0,5198,0,0,0,40,,3,,,,,137,A
20200411,AK,7732,300,257,11,7475,289,8,1,31,,3,,,,,63,A
20200411,AL,21249,223,3191,223,18058,0,91,11,402,,34,,177,,113,,B
20200411,AR,18578,1458,1226,55,17352,1403,24,1,130,86,0,,43,33,39,340,A
20200411,AS,3,0,0,0,3,0,,0,,,0,,,,,,
20200411,AZ,40530,2796,3393,281,37137,2515,108,11,1037,,42,,,,,,B
20200411,CA,173219,8356,20615,1143,152604,7213,609,68,,5236,0,1591,,,,,B
20200411,CO,32653,0,6510,0,26143,0,250,0,1312,841,0,,,,,,A
20200411,CT,39831,3543,11510,972,28321,2571,494,46,,1593,0,,,,,,A
20200411,DC,10039,684,1778,118,8261,566,47,9,,,0,,,,,447,A
20200411,DE,11103,-638,1479,153,9624,-791,43,7,,190,0,,,,,191,A
20200411,FL,172933,10103,18494,963,154439,9140,438,48,2661,,174,,,,,,A
20200411,GA,51715,5568,12159,676,39556,4892,428,12,2479,,128,,,,,,A
20200411,GU,826,34,133,3,693,31,5,1,,14,0,2,,2,,58,
20200411,HI,17531,1382,465,23,17066,1359,8,2,43,,1,,6,,2,284,A
20200411,IA,17132,1179,1510,122,15622,1057,34,3,,118,0,55,,30,,585,A
20200411,ID,13764,670,1396,43,12368,627,25,1,128,61,1,,35,,,,A
20200411,IL,92149,4622,19180,1293,72969,3329,677,81,,3680,0,1166,,821,,,A
20200411,IN,39215,4175,7435,528,31780,3647,330,30,,,0,820,,497,,,B
20200411,KS,12343,929,1268,102,11075,827,55,5,293,,19,,,,,,B
20200411,KY,24288,0,1693,0,22595,0,90,0,459,271,0,105,177,,,464,A
20200411,LA,96915,4635,20014,761,76901,3874,806,51,,2067,0,,,470,,,A
20200411,MA,108881,6439,22766,1888,86115,4551,946,114,2507,2507,72,,,,,,B
20200411,MD,47238,2790,7694,726,39544,2064,298,43,1709,,296,,,,,431,A
20200411,ME,6704,30,616,30,6088,0,19,2,114,,3,,,,,256,A
20200411,MI,93221,3452,30980,808,62241,2644,2081,164,,3636,0,1582,,1441,,595,B
20200411,MN,38704,1626,1806,74,36898,1552,64,7,340,145,23,69,138,,,729,A
20200411,MO,43172,2432,4024,225,39148,2207,109,13,,506,0,,,,,,A
20200411,MP,38,0,11,0,27,0,2,0,,,0,,,,,,
20200411,MS,21274,173,2642,173,18632,0,93,11,528,,46,,,,,,A
20200411,MT,8581,284,377,12,8204,272,6,0,46,21,5,,,,,169,A
20200411,NC,60393,2748,4312,404,56081,2344,80,6,,362,0,,,,,,A
20200411,ND,10080,472,293,15,9787,457,7,1,36,10,0,,,,,119,B
20200411,NE,9985,631,700,65,9285,566,17,2,,,0,,,,,,A
20200411,NH,10493,535,885,66,9608,469,22,1,134,,10,,,,,234,B
20200411,NJ,120193,6670,58151,3563,62042,3107,2183,251,,7618,0,1746,,1650,,,A
20200411,NM,27098,0,1091,0,26007,0,19,0,,75,0,,,18,,235,A
20200411,NV,23587,838,2700,116,20887,722,125,5,,282,0,,,,,,A
20200411,NY,440980,23095,180458,9946,260522,13149,8627,783,48297,18654,2529,5009,,,,22025,A
20200411,OH,60471,1898,6250,372,54221,1526,247,16,1859,,104,,572,,,,B
20200411,OK,22658,494,1868,74,20790,420,94,6,446,383,18,191,,,,865,B
20200411,OR,27224,1597,1371,50,25853,1547,48,4,338,140,12,58,,46,,,A
20200411,PA,120153,7134,21655,1676,98498,5458,494,78,,2115,0,,,639,,,A
20200411,PR,6371,525,788,63,5583,462,42,3,,,0,,,,,,A
20200411,RI,19983,2007,2853,280,17130,1727,56,7,,183,0,50,,26,,35,B
20200411,SC,30093,1910,3207,142,26886,1768,80,8,496,,0,,,,,,B
20200411,SD,8004,357,626,90,7378,267,6,0,33,,4,,,,,189,A
20200411,TN,66828,4029,5114,252,61714,3777,101,3,556,411,20,,,,,1386,A
20200411,TX,120533,4815,12561,890,107972,3925,254,28,,1514,0,,,,,1617,A
20200411,UT,42546,1784,2206,104,40340,1680,18,1,190,,7,,,,,,A
20200411,VA,37999,2540,5077,568,32922,1972,130,9,,1252,-772,426,,283,,,A
20200411,VI,350,27,51,1,299,26,1,0,,3,0,,,,,43,
20200411,VT,8796,581,733,20,8063,561,25,1,,77,0,,,,,15,A
20200411,WA,130562,2076,11605,210,118957,1866,494,18,,649,0,191,,,,,C
20200411,WI,38502,1612,3822,157,34680,1455,137,9,950,444,46,179,257,,,,A
20200411,WV,15452,897,577,23,14875,874,5,0,,85,0,40,,22,,63,B
20200411,WY,5459,470,261,8,5198,462,0,0,37,,0,,,,,129,A
20200410,AK,7432,209,246,11,7186,198,7,0,28,,1,,,,,55,A
20200410,AL,21026,199,2968,199,18058,0,80,6,368,,35,,,,,,B
20200410,AR,17120,2169,1171,52,15949,2117,23,2,130,86,0,,43,33,39,312,A
20200410,AS,3,0,0,0,3,0,0,0,,,0,,,,,,
20200410,AZ,37734,556,3112,94,34622,462,97,8,995,,45,,,,,,B
20200410,CA,164863,1363,19472,1163,145391,200,541,49,,2897,0,1145,,,,,B
20200410,CO,32653,3454,6510,855,26143,2599,250,57,1312,842,150,,,,,,A
20200410,CT,36288,2786,10538,754,25750,2032,448,68,,1562,0,,,,,,A
20200410,DC,9355,631,1660,137,7695,494,38,6,,,0,,,,,426,A
20200410,DE,11741,1851,1326,119,10415,1732,36,2,,181,0,,,,,177,A
20200410,FL,162830,10281,17531,1167,145299,9114,390,36,2487,,219,,,,,,A
20200410,GA,46147,5062,11483,917,34664,4145,416,37,2351,,192,,,,,,A
20200410,GU,792,71,130,2,662,69,4,0,,14,0,2,,2,,41,
20200410,HI,16149,398,442,7,15707,391,6,1,42,,0,,6,,2,251,A
20200410,IA,15953,980,1388,118,14565,862,31,2,,125,0,55,,30,,506,A
20200410,ID,13094,563,1353,121,11741,442,24,6,127,67,14,,33,,,,A
20200410,IL,87527,6670,17887,1465,69640,5205,596,68,,3680,0,1166,,821,,,A
20200410,IN,35040,2907,6907,556,28133,2351,300,55,,,0,820,,497,,,B
20200410,KS,11414,639,1166,60,10248,579,50,8,274,,11,,,,,,B
20200410,KY,24288,2487,1693,347,22595,2140,90,17,459,271,459,105,177,,,464,A
20200410,LA,92280,5361,19253,970,73027,4391,755,53,,2054,0,,,479,,,A
20200410,MA,102442,7453,20878,2035,81564,5418,832,107,2435,2435,133,,,,,,B
20200410,MD,44448,2919,6968,783,37480,2136,255,34,1413,,65,,,,,397,A
20200410,ME,6674,26,586,26,6088,0,17,1,111,,6,,,,,246,A
20200410,MI,89769,4243,30172,1076,59597,3167,1917,161,,3823,0,1663,,1394,,56,B
20200410,MN,37078,1759,1732,95,35346,1664,57,7,317,143,24,64,131,,,675,A
20200410,MO,40740,2246,3799,260,36941,1986,96,19,,568,0,,,,,,A
20200410,MP,38,0,11,0,27,0,2,0,,,0,,,,,,
20200410,MS,21101,209,2469,209,18632,0,82,6,482,,41,,,,,,A
20200410,MT,8297,437,365,11,7932,426,6,0,41,29,5,,,,,165,A
20200410,NC,57645,9836,3908,257,53737,9579,74,9,,423,0,,,,,,A
20200410,ND,9608,618,278,9,9330,609,6,1,36,13,2,,,,,105,B
20200410,NE,9354,671,635,68,8719,603,15,1,,,0,,,,,,A
20200410,NH,9958,407,819,31,9139,376,21,3,124,,6,,,,,234,B
20200410,NJ,113523,6331,54588,3561,58935,2770,1932,232,,7570,0,1679,,1663,,682,A
20200410,NM,27098,3291,1091,226,26007,3065,19,3,,73,0,,,18,,217,A
20200410,NV,22749,978,2584,128,20165,850,120,10,,282,0,,,,,,A
20200410,NY,417885,26336,170512,10575,247373,15761,7844,777,45768,18569,2916,4908,,,,20249,A
20200410,OH,58573,2588,5878,366,52695,2222,231,18,1755,,143,,548,,,,B
20200410,OK,22164,1885,1794,110,20370,1775,88,8,428,186,13,122,,,,790,B
20200410,OR,25627,0,1321,0,24306,0,44,0,326,146,0,66,,54,,,A
20200410,PA,113019,7417,19979,1751,93040,5666,416,78,,2072,0,,,611,,,A
20200410,PR,5846,460,725,42,5121,418,39,6,,,0,,,,,,A
20200410,RI,17976,2778,2573,404,15403,2374,49,6,,169,0,45,,26,,35,B
20200410,SC,28183,816,3065,273,25118,543,72,5,496,,255,,,,,,B
20200410,SD,7647,500,536,89,7111,411,6,0,29,,2,,,,,177,A
20200410,TN,62799,2950,4862,228,57937,2722,98,4,536,561,31,,,,,1145,A
20200410,TX,115718,9584,11671,1441,104047,8143,226,27,,1532,0,,,,,1366,A
20200410,UT,40762,2389,2102,126,38660,2263,17,4,183,,15,,,,,,A
20200410,VA,35459,2433,4509,467,30950,1966,121,12,772,1238,87,457,,287,,,A
20200410,VI,323,26,50,4,273,22,1,0,,3,0,,,,,43,
20200410,VT,8215,317,713,33,7502,284,24,1,,32,0,,,,,15,A
20200410,WA,128486,4299,11395,277,117091,4022,476,17,,642,0,191,,,,,C
20200410,WI,36890,2023,3665,222,33225,1801,128,17,904,,61,190,247,,,,A
20200410,WV,14555,692,554,31,14001,661,5,0,,85,0,20,,22,,63,B
20200410,WY,4989,839,253,23,4736,816,0,0,37,,3,,,,,105,A
20200409,AK,7223,155,235,9,6988,146,7,0,27,,0,,,,,49,A
20200409,AL,20827,1705,2769,400,18058,1305,74,8,333,,19,,,,,,B
20200409,AR,14951,421,1119,119,13832,302,21,3,130,73,0,,43,31,39,288,A
20200409,AS,3,0,0,0,3,0,0,0,,,0,,,,,,
20200409,AZ,37178,2614,3018,292,34160,2322,89,9,950,,44,,,,,,B
20200409,CA,163500,19236,18309,1352,145191,17884,492,50,,2825,0,1132,,,,,B
20200409,CO,29199,1105,5655,226,23544,879,193,14,1162,848,83,,,,,,A
20200409,CT,33502,4466,9784,2003,23718,2463,380,103,,1464,0,,,,,,A
20200409,DC,8724,441,1523,83,7201,358,32,5,,,0,,,,,393,A
20200409,DE,9890,1334,1207,279,8683,1055,34,2,,201,0,,,,,173,A
20200409,FL,152549,9415,16364,909,136185,8506,354,45,2268,,206,,,,,,A
20200409,GA,41085,2298,10566,665,30519,1633,379,17,2159,,166,,,,,,A
20200409,GU,721,34,128,3,593,31,4,0,,14,0,2,,2,,33,
20200409,HI,15751,602,435,25,15316,577,5,0,42,,0,,6,,,113,A
20200409,IA,14973,1007,1270,125,13703,882,29,2,,122,-193,,,,,476,A
20200409,ID,12531,633,1232,22,11299,611,18,3,113,70,20,,29,,,,A
20200409,IL,80857,5791,16422,1344,64435,4447,528,66,,3680,0,1166,,821,,,A
20200409,IN,32133,1264,6351,408,25782,856,245,42,,,0,924,,507,,,B
20200409,KS,10775,592,1106,60,9669,532,42,4,263,,40,,,,,,B
20200409,KY,21801,197,1346,197,20455,0,73,8,,,0,,,,,,A
20200409,LA,86919,5513,18283,1253,68636,4260,702,50,,2014,0,,,473,,,A
20200409,MA,94989,7448,18843,2151,76146,5297,725,110,2302,2302,183,,,,,,B
20200409,MD,41529,3067,6185,656,35344,2411,221,30,1348,,138,,,,,376,A
20200409,ME,6648,23,560,23,6088,0,16,2,105,,4,,,,,202,A
20200409,MI,85526,4286,29096,1032,56430,3254,1756,156,,3826,0,1628,,1434,,56,B
20200409,MN,35319,1831,1637,103,33682,1728,50,11,293,145,22,63,119,,,625,A
20200409,MO,38494,4384,3539,212,34955,4172,77,19,,568,0,,,,,,A
20200409,MP,38,0,11,0,27,0,2,0,,,0,,,,,,
20200409,MS,20892,257,2260,257,18632,0,76,9,441,,31,,,,,,A
20200409,MT,7860,462,354,22,7506,440,6,0,36,13,5,,,,,157,A
20200409,NC,47809,4822,3651,225,44158,4597,65,12,,398,0,,,,,,A
20200409,ND,8990,438,269,18,8721,420,5,1,34,14,0,,,,,101,B
20200409,NE,8683,722,567,48,8116,674,14,2,,,0,,,,,,A
20200409,NH,9551,374,788,0,8763,374,18,0,118,,0,,,,,227,B
20200409,NJ,107192,6776,51027,3590,56165,3186,1700,196,,7363,0,1523,,1551,,,A
20200409,NM,23807,1562,865,71,22942,1491,16,3,,59,0,,,18,,201,A
20200409,NV,21771,1205,2456,138,19315,1067,110,9,,282,0,,,,,,A
20200409,NY,391549,26396,159937,10621,231612,15775,7067,799,42852,18279,2870,4925,,,,18297,A
20200409,OH,55985,2644,5512,364,50473,2280,213,20,1612,,117,,497,,,,B
20200409,OK,20279,6934,1684,160,18595,6774,80,1,415,188,25,120,,,,686,B
20200409,OR,25627,1063,1321,82,24306,981,44,11,326,146,2,66,,54,,,A
20200409,PA,105602,7064,18228,1989,87374,5075,338,29,,2051,0,,,592,,,A
20200409,PR,5386,500,683,63,4703,437,33,9,,,0,,,,,,A
20200409,RI,15198,1641,2169,279,13029,1362,43,8,,160,0,45,,26,,35,B
20200409,SC,27367,2733,2792,240,24575,2493,67,4,241,,0,,,,,,B
20200409,SD,7147,399,447,54,6700,345,6,0,27,,1,,,,,161,A
20200409,TN,59849,3231,4634,272,55215,2959,94,15,505,639,56,,,,,921,A
20200409,TX,106134,9876,10230,877,95904,8999,199,22,,1439,0,,,,,1101,A
20200409,UT,38373,2257,1976,130,36397,2127,13,0,168,,10,,,,,,A
20200409,VA,33026,2381,4042,397,28984,1984,109,34,685,669,70,469,,285,,,A
20200409,VI,297,10,46,1,251,9,1,0,,,0,,,,,39,
20200409,VT,7898,266,680,49,7218,217,23,0,,33,-50,,,,,15,A
20200409,WA,124187,4306,11118,287,113069,4019,459,16,,650,0,191,,,,,A
20200409,WI,34867,1473,3443,164,31424,1309,111,12,843,,53,,230,,,,A
20200409,WV,13863,1318,523,61,13340,1257,5,1,,,0,,,,,,B
20200409,WY,4150,86,230,9,3920,77,0,0,34,,1,,,,,94,A
20200408,AK,7068,155,226,13,6842,142,7,1,27,,4,,,,,32,A
20200408,AL,19122,4206,2369,250,16753,3956,66,10,314,,43,,,,,,B
20200408,AR,14530,892,1000,54,13530,838,18,2,130,76,-18,,43,30,39,208,A
20200408,AS,3,0,0,0,3,0,0,0,,,0,,,,,,
20200408,AZ,34564,1189,2726,151,31838,1038,80,7,906,,53,,,,,,B
20200408,CA,144264,13035,16957,1092,127307,11943,442,68,,2714,0,1154,,,,,B
20200408,CO,28094,1219,5429,257,22665,962,179,29,1079,833,85,,,,,,A
20200408,CT,29036,0,7781,0,21255,0,277,0,,1308,0,,,,,,A
20200408,DC,8283,460,1440,229,6843,231,27,5,,,0,,,,,361,A
20200408,DE,8556,0,928,0,7628,0,32,4,,147,0,,,,,144,A
20200408,FL,143134,4972,15455,708,127679,4264,309,13,2062,,63,,,,,,A
20200408,GA,38787,5074,9901,1083,28886,3991,362,33,1993,,219,,,,,,A
20200408,GU,687,37,125,4,562,33,4,0,,21,0,2,,2,,31,
20200408,HI,15149,1607,410,23,14739,1584,5,0,42,,16,,6,,,113,A
20200408,IA,13966,1248,1145,97,12821,1151,27,1,193,122,0,,,,,431,A
20200408,ID,11898,652,1210,40,10688,612,15,2,93,62,10,,24,,,,A
20200408,IL,75066,6334,15078,1529,59988,4805,462,82,,3680,0,1166,,821,,,A
20200408,IN,30869,2105,5943,436,24926,1669,203,30,,,0,924,,507,,,B
20200408,KS,10183,669,1046,146,9137,523,38,11,223,,0,,,,,,B
20200408,KY,21604,1649,1149,141,20455,1508,65,6,,,0,,,,,,A
20200408,LA,81406,6751,17030,746,64376,6005,652,70,,1983,0,,,490,,,A
20200408,MA,87541,6167,16692,1588,70849,4579,615,100,2119,2119,288,,,,,,B
20200408,MD,38462,6835,5529,1158,32933,5677,191,31,1210,,104,,,,,365,A
20200408,ME,6625,18,537,18,6088,0,14,2,101,,2,,,,,187,A
20200408,MI,81240,3932,28064,1100,53176,2832,1600,151,,,0,,,,,56,B
20200408,MN,33488,1453,1534,102,31954,1351,39,5,271,135,29,64,105,,,593,A
20200408,MO,34110,2141,3327,290,30783,1851,58,5,,519,0,,,,,,A
20200408,MP,38,15,11,3,27,12,2,0,,,0,,,,,,
20200408,MS,20635,88,2003,88,18632,0,67,8,410,,33,,,,,,A
20200408,MT,7398,413,332,13,7066,400,6,0,31,,3,,,,,135,A
20200408,NC,42987,1905,3426,205,39561,1700,53,7,,386,0,,,,,,A
20200408,ND,8552,849,251,14,8301,835,4,0,34,16,1,,,,,98,B
20200408,NE,7961,703,519,72,7442,631,12,2,,,0,,,,,,A
20200408,NH,9177,443,788,73,8389,370,18,9,118,,15,,,,,211,B
20200408,NJ,100416,5442,47437,3021,52979,2421,1504,272,,7026,0,1617,,1576,,,A
20200408,NM,22245,420,794,108,21451,312,13,1,,51,0,,,18,,171,A
20200408,NV,20566,1927,2318,231,18248,1696,101,10,,282,0,,,,,,A
20200408,NY,365153,25095,149316,10453,215837,14642,6268,779,39982,18079,3050,4841,,,,16353,A
20200408,OH,53341,2503,5148,366,48193,2137,193,26,1495,,141,,472,,,,B
20200408,OK,13345,52,1524,52,11821,0,79,12,390,188,14,120,,,,686,B
20200408,OR,24564,1557,1239,58,23325,1499,33,0,324,156,0,61,,58,69,,A
20200408,PA,98538,7260,16239,1680,82299,5580,309,69,,1898,0,,,603,,,A
20200408,PR,4886,347,620,47,4266,300,24,1,,,0,,,,,,A
20200408,RI,13557,1845,1890,273,11667,1572,35,5,,143,0,45,,26,,35,B
20200408,SC,24634,954,2552,135,22082,819,63,12,241,,0,,,,,,B
20200408,SD,6748,480,393,73,6355,407,6,0,26,,3,,,,,146,A
20200408,TN,56618,3744,4362,224,52256,3520,79,7,449,708,41,,,,,592,A
20200408,TX,96258,7609,9353,1091,86905,6518,177,23,,1491,0,,,,,38,A
20200408,UT,36116,1469,1846,108,34270,1361,13,0,158,,10,,,,,,A
20200408,VA,30645,2000,3645,312,27000,1688,75,12,615,,52,,145,,108,,A
20200408,VI,287,22,45,2,242,20,1,0,,,0,,,,,39,
20200408,VT,7632,379,631,23,7001,356,23,0,50,35,5,,,,,15,A
20200408,WA,119881,4804,10831,284,109050,4520,443,14,,655,0,186,,,,,A
20200408,WI,33394,1818,3279,215,30115,1603,99,7,790,,45,,218,,,,A
20200408,WV,12545,486,462,50,12083,436,4,0,,,0,,,,,,B
20200408,WY,4064,59,221,5,3843,54,0,0,33,,0,,,,,62,A
20200407,AK,6913,30,213,22,6700,8,6,0,23,,0,,,,,29,A
20200407,AL,14916,151,2119,151,12797,0,56,6,271,,31,,,,,,B
20200407,AR,13638,793,946,71,12692,722,16,0,148,74,11,,,26,43,142,A
20200407,AS,3,0,0,0,3,0,0,0,,,0,,,,,,
20200407,AZ,33375,841,2575,119,30800,722,73,8,853,,34,,,,,,B
20200407,CA,131229,13798,15865,1529,115364,12269,374,31,,2611,0,1108,,,,,B
20200407,CO,26875,1102,5172,222,21703,880,150,10,994,786,70,,,,,,A
20200407,CT,29036,2350,7781,875,21255,1475,277,71,,1308,0,,,,,,A
20200407,DC,7823,370,1211,114,6612,256,22,-2,,,0,,,,,318,A
20200407,DE,8556,1562,928,255,7628,1307,28,4,,147,0,,,,,144,A
20200407,FL,138162,14888,14747,1423,123415,13465,296,60,1999,,317,,,,,,A
20200407,GA,33713,2439,8818,1504,24895,935,329,100,1774,,442,,,,,,A
20200407,GU,650,32,121,8,529,24,4,0,,21,0,2,,2,,27,
20200407,HI,13542,16,387,16,13155,0,5,1,26,,5,,6,,,89,A
20200407,IA,12718,1119,1048,102,11670,1017,26,1,193,104,14,,,,,341,A
20200407,ID,11246,251,1170,69,10076,182,13,3,83,67,6,,21,,,,A
20200407,IL,68732,5790,13549,1287,55183,4503,380,73,,3680,0,1166,,821,,,A
20200407,IN,28764,2573,5507,563,23257,2010,173,34,,,0,924,,507,,,B
20200407,KS,9514,430,900,55,8614,375,27,2,223,,25,,,,,,B
20200407,KY,19955,1188,1008,53,18947,1135,59,14,,,0,,,,,,A
20200407,LA,74655,5489,16284,1417,58371,4072,582,70,,1996,0,,,519,,,A
20200407,MA,81374,4915,15104,1365,66270,3550,515,67,1831,1831,164,,,,,,B
20200407,MD,31627,2010,4371,326,27256,1684,160,22,1106,,47,,,,,288,A
20200407,ME,6607,20,519,20,6088,0,12,2,99,,7,,,,,176,A
20200407,MI,77308,4261,26964,1179,50344,3082,1449,158,,,0,,,,,56,B
20200407,MN,32035,1550,1432,102,30603,1448,34,4,242,120,19,64,100,,,515,A
20200407,MO,31969,2134,3037,315,28932,1819,53,14,,508,0,,,,,,A
20200407,MP,23,2,8,0,15,2,2,1,,,0,,,,,,
20200407,MS,20547,177,1915,177,18632,0,59,8,377,,-98,,,,,,A
20200407,MT,6985,195,319,20,6666,175,6,0,28,,4,,,,,,A
20200407,NC,41082,356,3221,351,37861,5,46,13,,354,0,,,,,,A
20200407,ND,7703,490,237,12,7466,478,4,1,33,18,1,,,,,82,B
20200407,NE,7258,471,447,38,6811,433,10,2,,,0,,,,,,A
20200407,NH,8734,364,715,46,8019,318,9,0,103,,11,,,,,151,B
20200407,NJ,94974,5942,44416,3326,50558,2616,1232,229,,7017,0,1651,,1540,,,A
20200407,NM,21825,2689,686,62,21139,2627,12,0,,48,0,,,18,,133,A
20200407,NV,18639,1010,2087,134,16552,876,91,12,,282,0,,,,,,A
20200407,NY,340058,19247,138863,8174,201195,11073,5489,731,36932,17493,2555,4539,,,,14590,A
20200407,OH,50838,2460,4782,332,46056,2128,167,25,1354,,140,,417,,,,B
20200407,OK,13293,10544,1472,145,11821,10399,67,16,376,186,36,137,,,,612,B
20200407,OR,23007,1206,1181,49,21826,1157,33,6,324,,66,,,69,,,A
20200407,PA,91278,7424,14559,1579,76719,5845,240,78,,1665,-1145,,,548,,,A
20200407,PR,4539,594,573,60,3966,534,23,2,,,0,,,,,,A
20200407,RI,11712,1747,1617,261,10095,1486,30,3,,123,0,40,,26,,35,B
20200407,SC,23680,4704,2417,368,21263,4336,51,7,241,,0,,,,,,B
20200407,SD,6268,248,320,32,5948,216,6,2,23,,0,,,,,98,A
20200407,TN,52874,5524,4138,336,48736,5188,72,7,408,802,56,,,,,466,A
20200407,TX,88649,3292,8262,986,80387,2306,154,14,,1252,0,,,,,38,A
20200407,UT,34647,1253,1738,63,32909,1190,13,0,148,,10,,,,,,A
20200407,VA,28645,4124,3333,455,25312,3669,63,9,563,,66,,145,,108,,A
20200407,VI,265,0,43,0,222,0,1,0,,,0,,,,,36,
20200407,VT,7253,517,608,33,6645,484,23,0,45,29,0,,,,,15,A
20200407,WA,115077,5229,10547,265,104530,4964,429,22,,641,0,190,,,,,A
20200407,WI,31576,2136,3064,198,28512,1938,92,15,745,,77,,200,,,,A
20200407,WV,12059,2119,412,67,11647,2052,4,0,,,0,,,,,,B
20200407,WY,4005,76,216,6,3789,70,0,0,33,,10,,,,,62,A
20200406,AK,6883,599,191,6,6692,593,6,0,23,,3,,,,,,A
20200406,AL,14765,1687,1968,172,12797,1515,50,5,240,,9,,,,,,B
20200406,AR,12845,1603,875,45,11970,1558,16,0,137,74,7,,,22,39,102,A
20200406,AS,3,0,0,0,3,0,0,0,,,0,,,,,,
20200406,AZ,32534,5124,2456,187,30078,4937,65,1,819,,59,,,,,,B
20200406,CA,117431,898,14336,898,103095,0,343,24,,2509,0,1085,,,,,B
20200406,CO,25773,1873,4950,385,20823,1488,140,14,924,786,49,,,,,,A
20200406,CT,26686,3416,6906,1231,19780,2185,206,17,,1221,0,,,,,,A
20200406,DC,7453,619,1097,99,6356,520,24,2,,,0,,,,,287,A
20200406,DE,6994,0,673,0,6321,0,24,5,,101,0,,,,,71,A
20200406,FL,123274,9870,13324,1173,109950,8697,236,18,1682,,110,,,,,,A
20200406,GA,31274,3442,7314,667,23960,2775,229,18,1332,,49,,,,,,A
20200406,GU,618,13,113,1,505,12,4,0,,21,0,2,,,,25,
20200406,HI,13526,571,371,20,13155,551,4,0,21,,2,,6,,,85,A
20200406,IA,11599,758,946,78,10653,680,25,3,179,99,14,,,,,284,A
20200406,ID,10995,734,1101,24,9894,710,10,0,77,62,11,,16,,,,A
20200406,IL,62942,3959,12262,1006,50680,2953,307,33,,,0,,,,,,A
20200406,IN,26191,3539,4944,533,21247,3006,139,12,,,0,924,,507,,,B
20200406,KS,9084,861,845,98,8239,763,25,3,198,,15,,,,,,B
20200406,KY,18767,2104,955,38,17812,2066,45,5,,,0,,,,,,A
20200406,LA,69166,8841,14867,1857,54299,6984,512,35,,1981,0,,,552,,,A
20200406,MA,76459,4492,13739,1337,62720,3155,448,78,1667,1667,35,,,,,,B
20200406,MD,29617,1280,4045,436,25572,844,138,16,1059,,123,,,,,184,A
20200406,ME,6587,29,499,29,6088,0,10,0,92,,6,,,,,158,A
20200406,MI,73047,4435,25785,1327,47262,3108,1291,141,,,0,,,,,56,B
20200406,MN,30485,1178,1330,113,29155,1065,30,1,223,115,21,57,90,,,440,A
20200406,MO,29835,2586,2722,355,27113,2231,39,5,,439,0,,,,,,A
20200406,MP,21,0,8,0,13,0,1,0,,,0,,,,,,
20200406,MS,20370,13152,1738,100,18632,13052,51,8,475,,0,,,,,,A
20200406,MT,6790,187,299,13,6491,174,6,0,24,,0,,,,,,A
20200406,NC,40726,681,2870,285,37856,396,33,2,,270,0,,,,,,A
20200406,ND,7213,426,225,18,6988,408,3,0,32,19,1,,,,,74,B
20200406,NE,6787,866,409,46,6378,820,8,0,,,0,,,,,,A
20200406,NH,8370,338,669,48,7701,290,9,0,92,,6,,,,,147,B
20200406,NJ,89032,6866,41090,3585,47942,3281,1003,86,,6390,0,,,1263,,,A
20200406,NM,19136,2308,624,81,18512,2227,12,1,,45,0,,,18,,130,A
20200406,NV,17629,798,1953,117,15676,681,79,3,,,0,,,,,,A
20200406,NY,320811,18531,130689,8658,190122,9873,4758,599,34377,16837,2084,4504,,,,13366,A
20200406,OH,48378,4622,4450,407,43928,4215,142,23,1214,,110,,371,,,,B
20200406,OK,2749,96,1327,75,1422,21,51,5,340,161,10,143,,,,522,B
20200406,OR,21801,1177,1132,64,20669,1113,27,0,258,,0,,,40,,,A
20200406,PA,83854,6083,12980,1470,70874,4613,162,12,1145,,73,,,533,,,A
20200406,PR,3945,397,513,38,3432,359,21,1,,,0,,,,,,A
20200406,RI,9965,1783,1356,206,8609,1577,27,2,,109,0,37,,26,,35,B
20200406,SC,18976,0,2049,0,16927,0,44,0,241,,0,,,,,,B
20200406,SD,6020,427,288,48,5732,379,4,2,23,,1,,,,,91,A
20200406,TN,47350,2050,3802,169,43548,1881,65,21,352,834,24,,,,,356,A
20200406,TX,85357,14419,7276,464,78081,13955,140,13,,1153,0,,,,,38,A
20200406,UT,33394,2502,1675,70,31719,2432,13,5,138,,14,,,,,,A
20200406,VA,24521,850,2878,241,21643,609,54,3,497,,66,,145,,108,,A
20200406,VI,265,17,43,1,222,16,1,0,,,0,,,,,36,
20200406,VT,6736,363,575,32,6161,331,23,1,45,28,0,,,,,15,A
20200406,WA,109848,5136,10282,329,99566,4807,407,21,,638,0,191,,,,,A
20200406,WI,29440,1628,2866,223,26574,1405,77,9,668,,44,,186,,,,A
20200406,WV,9940,1102,345,21,9595,1081,4,1,,,0,,,,,,B
20200406,WY,3929,692,210,13,3719,679,0,0,23,,0,,,,,52,A
20200405,AK,6284,244,185,14,6099,230,6,1,20,,4,,,,,,A
20200405,AL,13078,2225,1796,216,11282,2009,45,2,231,,19,,,,,,B
20200405,AR,11242,872,830,87,10412,785,16,2,130,67,24,,,27,39,97,A
20200405,AS,3,0,0,0,3,0,0,0,,,0,,,,,,
20200405,AZ,27410,250,2269,250,25141,0,64,12,760,,49,,,,,,B
20200405,CA,116533,2833,13438,1412,103095,1421,319,43,,2398,0,1040,,,,,B
20200405,CO,23900,1829,4565,392,19335,1437,126,15,875,783,52,,,,,,A
20200405,CT,23270,1241,5675,399,17595,842,189,24,,1142,0,,,,,,A
20200405,DC,6834,396,998,96,5836,300,22,1,,,0,,,,,258,A
20200405,DE,6994,527,673,80,6321,447,19,2,,101,0,,,,,71,C
20200405,FL,113404,11337,12151,1040,101253,10297,218,27,1572,,110,,,,,,A
20200405,GA,27832,1538,6647,487,21185,1051,211,10,1283,,44,,,,,,A
20200405,GU,605,40,112,19,493,21,4,0,,21,0,2,,,,23,
20200405,HI,12955,677,351,32,12604,645,4,1,19,,1,,6,,,82,A
20200405,IA,10841,601,868,82,9973,519,22,8,165,91,12,,,,,188,C
20200405,ID,10261,1391,1077,64,9184,1327,10,0,66,51,4,,11,,,,A
20200405,IL,58983,5402,11256,899,47727,4503,274,31,,,0,,,,,,A
20200405,IN,22652,2852,4411,458,18241,2394,127,11,,,0,,,,,,B
20200405,KS,8223,645,747,49,7476,596,22,1,183,,11,,,,,,B
20200405,KY,16663,1091,917,86,15746,1005,40,3,,,0,,,,,,A
20200405,LA,60325,1827,13010,514,47315,1313,477,68,,1803,0,,,561,,,A
20200405,MA,71967,3139,12402,765,59565,2374,370,66,1632,1632,262,,,,,,B
20200405,MD,28337,2727,3609,484,24728,2243,122,21,936,,115,,,,,159,A
20200405,ME,6558,14,470,14,6088,0,10,0,86,,3,,,,,156,A
20200405,MI,68612,3826,24458,877,44154,2949,1150,120,,,0,,,,,56,B
20200405,MN,29307,1462,1217,59,28090,1403,29,5,202,106,22,48,77,,,422,A
20200405,MO,27249,2344,2367,76,24882,2268,34,10,,424,0,,,,,,C
20200405,MP,21,0,8,0,13,0,1,0,,,0,,,,,,
20200405,MS,7218,630,1638,183,5580,447,43,8,475,,39,,,,,,B
20200405,MT,6603,426,286,21,6317,405,6,1,24,,0,,,,,,A
20200405,NC,40045,1272,2585,183,37460,1089,31,7,,261,0,,,,,,A
20200405,ND,6787,580,207,21,6580,559,3,0,31,20,1,,,,,63,B
20200405,NE,5921,542,363,42,5558,500,8,2,,,0,,,,,,A
20200405,NH,8032,527,621,81,7411,446,9,2,86,,6,,,,,146,B
20200405,NJ,82166,6810,37505,3381,44661,3429,917,71,,4000,0,,,,,,A
20200405,NM,16828,1196,543,48,16285,1148,11,1,,37,0,,,18,,54,A
20200405,NV,16831,668,1836,94,14995,574,76,6,,,0,,,,,,A
20200405,NY,302280,18659,122031,8327,180249,10332,4159,594,32293,16479,2822,4376,,,,12187,A
20200405,OH,43756,1885,4043,304,39713,1581,119,17,1104,,98,,346,,,,B
20200405,OK,2653,132,1252,93,1401,39,46,4,330,,14,,,,,,B
20200405,OR,20624,3090,1068,69,19556,3021,27,1,258,,19,,,40,,,A
20200405,PA,77771,7741,11510,1493,66261,6248,150,14,1072,,68,,,,,,A
20200405,PR,3548,491,475,23,3073,468,20,2,,,0,,,,,,A
20200405,RI,8182,1252,1150,182,7032,1070,25,8,,103,0,33,,6,,35,B
20200405,SC,18976,662,2049,132,16927,530,44,4,241,,0,,,,,,B
20200405,SD,5593,369,240,28,5353,341,2,0,22,,3,,,,,84,A
20200405,TN,45300,3909,3633,312,41667,3597,44,1,328,637,17,,,,,295,A
20200405,TX,70938,7187,6812,702,64126,6485,127,22,,827,0,,,,,38,A
20200405,UT,30892,2849,1605,177,29287,2672,8,0,124,,7,,,,,,A
20200405,VA,23671,2119,2637,230,21034,1889,51,-1,431,,41,,145,,108,,A
20200405,VI,248,24,42,2,206,22,1,1,,,0,,,,,34,
20200405,VT,6373,619,543,31,5830,588,22,2,45,29,0,,,,,15,A
20200405,WA,104712,1952,9953,221,94759,1731,386,21,,581,0,178,,,,,A
20200405,WI,27812,1477,2643,167,25169,1310,68,12,624,,36,,175,,,,A
20200405,WV,8838,1152,324,42,8514,1110,3,1,,,0,,,,,,B
20200405,WY,3237,105,197,10,3040,95,0,0,23,,0,,,,,50,A
20200404,AK,6040,24,171,14,5869,10,5,2,16,,1,,,,,,A
20200404,AL,10853,1234,1580,148,9273,1086,43,8,212,,212,,,,,,B
20200404,AR,10370,671,743,39,9627,632,14,2,106,72,1,,,23,39,79,A
20200404,AS,3,0,0,0,3,0,0,0,,,0,,,,,,
20200404,AZ,27160,2487,2019,250,25141,2237,52,11,711,,44,,,,,,B
20200404,CA,113700,78400,12026,1325,101674,77075,276,39,,2300,0,1008,,,,,B
20200404,CO,22071,1660,4173,445,17898,1215,111,14,823,777,113,,,,,,A
20200404,CT,22029,2014,5276,362,16753,1652,165,34,,1033,0,,,,,,A
20200404,DC,6438,854,902,145,5536,709,21,6,,,0,,,,,235,A
20200404,DE,6467,1022,593,143,5874,879,17,0,,95,0,,,,,71,C
20200404,FL,102067,10345,11111,1526,90956,8819,191,28,1462,,175,,,,,,A
20200404,GA,26294,1029,6160,329,20134,700,201,17,1239,,81,,,,,,A
20200404,GU,565,22,93,9,472,13,4,0,,20,0,2,,,,20,
20200404,HI,12278,1787,319,34,11959,1753,3,1,18,,3,,6,,,78,A
20200404,IA,10240,787,786,87,9454,700,14,3,153,85,15,,,,,188,C
20200404,ID,8870,925,1013,122,7857,803,10,1,62,53,6,,8,,,,A
20200404,IL,53581,5533,10357,1453,43224,4080,243,33,,,0,,,,,,A
20200404,IN,19800,1965,3953,516,15847,1449,116,14,,,0,,,,,,B
20200404,KS,7578,504,698,78,6880,426,21,4,172,,21,,,,,,B
20200404,KY,15572,2768,831,61,14741,2707,37,6,,,0,,,,,,A
20200404,LA,58498,4853,12496,2199,46002,2654,409,39,,1726,0,,,571,,,A
20200404,MA,68828,5840,11637,1334,57191,4506,304,39,1370,1370,404,,,,,,B
20200404,MD,25610,1920,3125,367,22485,1553,101,17,821,,157,,,,,159,A
20200404,ME,6544,24,456,24,6088,0,10,1,83,,8,,,,,140,A
20200404,MI,64786,5147,23581,1002,41205,4145,1030,112,,,0,,,,,56,B
20200404,MN,27845,1663,1158,39,26687,1624,24,2,180,95,24,42,69,,,416,A
20200404,MO,24905,3435,2291,178,22614,3257,24,5,,413,0,,,,,,C
20200404,MP,21,0,8,0,13,0,1,0,,,0,,,,,,
20200404,MS,6588,477,1455,97,5133,380,35,6,436,,16,,,,,,B
20200404,MT,6177,601,265,22,5912,579,5,0,24,,0,,,,,,A
20200404,NC,38773,7175,2402,309,36371,6866,24,5,,271,0,,,,,,A
20200404,ND,6207,409,186,13,6021,396,3,0,30,,1,,,,,63,B
20200404,NE,5379,613,321,42,5058,571,6,0,,,0,,,,,,A
20200404,NH,7505,451,540,61,6965,390,7,2,80,,7,,,,,144,B
20200404,NJ,75356,7853,34124,4229,41232,3624,846,200,,4000,0,,,,,,A
20200404,NM,15632,854,495,92,15137,762,10,3,,41,0,,,18,,26,A
20200404,NV,16163,1631,1742,228,14421,1403,70,11,,,0,,,,,,A
20200404,NY,283621,23101,113704,10841,169917,12260,3565,630,29471,15905,3261,4126,,,,10478,A
20200404,OH,41871,3496,3739,427,38132,3069,102,11,1006,,111,,326,,,,B
20200404,OK,2521,218,1159,171,1362,47,42,4,316,,27,,,,,,B
20200404,OR,17534,100,999,100,16535,0,26,4,239,,35,,,38,,,A
20200404,PA,70030,7915,10017,1597,60013,6318,136,34,1004,,152,,,,,,A
20200404,PR,3057,630,452,74,2605,556,18,3,,,0,,,,,,A
20200404,RI,6930,757,968,137,5962,620,17,3,,93,0,31,,6,,35,B
20200404,SC,18314,11319,1917,363,16397,10956,40,9,241,,0,,,,,,B
20200404,SD,5224,444,212,25,5012,419,2,0,19,,2,,,,,76,A
20200404,TN,41391,3552,3321,254,38070,3298,43,6,311,601,18,,,,,416,A
20200404,TX,63751,7987,6110,780,57641,7207,105,15,,196,0,,,,,38,A
20200404,UT,28043,3795,1428,182,26615,3613,8,1,117,,11,,,,,,A
20200404,VA,21552,2547,2407,395,19145,2152,52,6,390,,78,,145,,108,,A
20200404,VI,224,32,40,2,184,30,,0,,,0,,,,,34,
20200404,VT,5754,429,512,52,5242,377,20,3,45,29,0,,,,,15,A
20200404,WA,102760,2614,9732,247,93028,2367,365,27,,574,0,174,,,,,A
20200404,WI,26335,1695,2476,213,23859,1482,56,19,588,,101,,,,,,A
20200404,WV,7686,1319,282,45,7404,1274,2,0,,,-1,,,,,,B
20200404,WY,3132,266,187,25,2945,241,0,0,23,,2,,,,,49,A
20200403,AK,6016,994,157,14,5859,980,3,0,15,,6,,,,,,A
20200403,AL,9619,883,1432,199,8187,684,35,3,,,0,,,,,,B
20200403,AR,9699,1176,704,61,8995,1115,12,0,105,71,5,,,26,39,60,A
20200403,AS,3,0,0,0,3,0,0,0,,,0,,,,,,
20200403,AZ,24673,1964,1769,171,22904,1793,41,9,667,,51,,,,,,B
20200403,CA,35300,2300,10701,1510,24599,790,237,34,,2188,0,901,,,,,B
20200403,CO,20411,1766,3728,386,16683,1380,97,17,710,739,90,,,,,,A
20200403,CT,20015,1715,4914,1090,15101,625,131,19,,909,0,,,,,,A
20200403,DC,5584,514,757,104,4827,410,15,3,,,0,,,,,206,A
20200403,DE,5445,486,450,57,4995,429,17,1,,63,0,,,,,71,C
20200403,FL,91722,14426,9585,1575,82137,12851,163,35,1287,,164,,,,,,A
20200403,GA,25265,2308,5831,483,19434,1825,184,21,1158,,102,,,,,,A
20200403,GU,543,19,84,2,459,17,4,1,,19,0,2,,,,14,
20200403,HI,10491,27,285,27,10206,0,2,1,15,,0,,6,,,72,A
20200403,IA,9453,785,699,85,8754,700,11,0,138,80,18,,,,,188,C
20200403,ID,7945,663,891,222,7054,441,9,0,56,45,7,,7,,,,A
20200403,IL,48048,4392,8904,1209,39144,3183,210,53,,,0,,,,,,A
20200403,IN,17835,1550,3437,398,14398,1152,102,24,,,0,,,,,,B
20200403,KS,7074,463,620,68,6454,395,17,4,151,,13,,,,,,B
20200403,KY,12804,4904,770,90,12034,4814,31,11,,,0,,,,,,A
20200403,LA,53645,2559,10297,1147,43348,1412,370,60,,1707,0,,,535,,,A
20200403,MA,62988,6354,10303,1436,52685,4918,265,36,966,,153,,,,,,B
20200403,MD,23690,2469,2758,427,20932,2042,84,20,664,,82,,,,,159,A
20200403,ME,6520,56,432,56,6088,0,9,2,75,,7,,,,,113,A
20200403,MI,59639,4820,22579,1203,37060,3617,918,117,,,0,,,,,56,B
20200403,MN,26182,1346,1119,63,25063,1283,22,4,156,86,18,40,40,,,,A
20200403,MO,21470,1787,2113,279,19357,1508,19,0,,,0,,,,,,C
20200403,MP,21,0,8,0,13,0,1,0,,,0,,,,,,
20200403,MS,6111,181,1358,181,4753,0,29,3,420,,60,,,,,,B
20200403,MT,5576,256,243,16,5333,240,5,0,24,,4,,,,,,A
20200403,NC,31598,2919,2093,236,29505,2683,19,3,,184,0,,,,,,A
20200403,ND,5798,818,173,14,5625,804,3,0,29,,1,,,,,55,B
20200403,NE,4766,542,279,33,4487,509,6,1,,,0,,,,,,A
20200403,NH,7054,561,479,64,6575,497,5,1,73,,15,,,,,101,B
20200403,NJ,67503,8393,29895,4305,37608,4088,646,109,,3016,0,,,,,,A
20200403,NM,14778,767,403,40,14375,727,7,1,,31,0,,,,,26,A
20200403,NV,14532,486,1514,56,13018,430,59,8,,,0,,,,,,A
20200403,NY,260520,21555,102863,10482,157657,11073,2935,562,26210,14810,3424,3731,,,,8886,A
20200403,OH,38375,3457,3312,410,35063,3047,91,10,895,,93,,288,,,,B
20200403,OK,2303,159,988,109,1315,50,38,4,289,171,32,123,,,,383,B
20200403,OR,17434,1349,899,73,16535,1276,22,1,204,188,16,,,38,,,A
20200403,PA,62115,7401,8420,1404,53695,5997,102,12,852,,122,,,,,,A
20200403,PR,2427,507,378,62,2049,445,15,3,,,0,,,,,,A
20200403,RI,6173,818,831,101,5342,717,14,2,,77,0,14,,6,,35,B
20200403,SC,6995,0,1554,0,5441,0,31,0,241,,0,,,,,,B
20200403,SD,4780,398,187,22,4593,376,2,0,17,,0,,,,,69,A
20200403,TN,37839,3228,3067,222,34772,3006,37,5,293,625,30,,,,,248,A
20200403,TX,55764,5085,5330,661,50434,4424,90,20,,196,0,,,,,38,A
20200403,UT,24248,3019,1246,172,23002,2847,7,0,106,,6,,,,,,A
20200403,VA,19005,1416,2012,306,16993,1110,46,5,312,,7,,145,,108,,A
20200403,VI,192,10,38,5,154,5,,0,,,0,,,,,29,
20200403,VT,5325,551,460,70,4865,481,17,0,45,29,0,,,,,15,A
20200403,WA,100146,4854,9485,284,90661,4570,338,28,,,0,,,,,,A
20200403,WI,24640,2283,2263,223,22377,2060,37,6,487,,26,,,,,,A
20200403,WV,6367,874,237,20,6130,854,2,0,1,,0,,,,,,B
20200403,WY,2866,277,162,12,2704,265,0,0,21,,2,,,,,37,A
20200402,AK,5022,419,143,10,4879,409,3,0,9,,0,,,,,,A
20200402,AL,8736,962,1233,156,7503,806,32,6,,,0,,,,,,B
20200402,AR,8523,585,643,59,7880,526,12,2,100,66,10,,,23,32,47,A
20200402,AS,3,0,0,0,3,0,0,0,,,0,,,,,,
20200402,AZ,22709,1651,1598,185,21111,1466,32,3,616,,34,,,,,,B
20200402,CA,33000,3073,9191,1036,23809,2037,203,32,,1922,0,816,,,,,B
20200402,CO,18645,1796,3342,376,15303,1420,80,11,620,698,111,,,,,,A
20200402,CT,18300,1700,3824,267,14476,1433,112,27,,827,0,,,,,,A
20200402,DC,5070,1222,653,67,4417,1155,12,1,,,0,,,,,173,A
20200402,DE,4959,576,393,25,4566,551,16,3,,56,0,,,,,49,C
20200402,FL,77296,10812,8010,1055,69286,9757,128,41,1123,,174,,,,,,A
20200402,GA,22957,2631,5348,710,17609,1921,163,24,1056,,104,,,,,,A
20200402,GU,524,41,82,5,442,36,3,0,,19,0,2,,,,12,
20200402,HI,10464,1535,258,50,10206,1485,1,0,15,,2,,6,,,69,A
20200402,IA,8668,815,614,65,8054,750,11,2,120,74,21,,,,,46,C
20200402,ID,7282,681,669,144,6613,537,9,0,49,49,3,,7,,,,A
20200402,IL,43656,3272,7695,715,35961,2557,157,16,,,0,,,,,,A
20200402,IN,16285,1910,3039,474,13246,1436,78,13,,,0,,,,,,B
20200402,KS,6611,718,552,70,6059,648,13,3,138,,24,,,,,,B
20200402,KY,7900,344,680,89,7220,255,20,3,,,0,,,,,,A
20200402,LA,51086,5310,9150,2726,41936,2584,310,37,,1639,0,,,507,,,A
20200402,MA,56634,4870,8867,1228,47767,3642,229,42,813,,131,,,,,,B
20200402,MD,21221,2003,2331,346,18890,1657,64,12,582,,60,,,,,81,A
20200402,ME,6464,32,376,32,6088,0,7,0,68,,5,,,,,94,A
20200402,MI,54819,4622,21376,1130,33443,3492,801,125,,,0,,,,,,B
20200402,MN,24836,1983,1056,83,23780,1900,18,1,138,75,16,38,38,,,,A
20200402,MO,19683,2256,1834,253,17849,2003,19,1,,,0,,,,,,C
20200402,MP,21,15,8,2,13,13,1,1,,,0,,,,,,
20200402,MS,5930,1145,1177,104,4753,1041,26,4,360,,28,,,,,,B
20200402,MT,5320,402,227,19,5093,383,5,0,20,,3,,,,,,A
20200402,NC,28679,2436,1857,273,26822,2163,16,6,,184,0,,,,,,A
20200402,ND,4980,487,159,17,4821,470,3,0,28,,5,,,,,43,B
20200402,NE,4224,539,246,36,3978,503,5,1,,,0,,,,,,A
20200402,NH,6493,93,415,0,6078,93,4,0,58,,2,,,,,91,B
20200402,NJ,59110,6468,25590,3335,33520,3133,537,182,,2000,0,,,,,,A
20200402,NM,14011,771,363,48,13648,723,6,1,,31,0,,,,,26,A
20200402,NV,14046,1248,1458,179,12588,1069,51,6,,,0,,,,,,A
20200402,NY,238965,18085,92381,8669,146584,9416,2373,432,22786,13383,2857,3396,,,,7434,A
20200402,OH,34918,5379,2902,355,32016,5024,81,16,802,,123,,260,,,,B
20200402,OK,2144,177,879,160,1265,17,34,4,257,182,38,144,,,,,B
20200402,OR,16085,2213,826,90,15259,2123,21,3,188,134,34,,,38,,,A
20200402,PA,54714,6482,7016,1211,47698,5271,90,16,730,,110,,,,,,A
20200402,PR,1920,225,316,30,1604,195,12,1,,,0,,,,,,A
20200402,RI,5355,498,730,62,4625,436,12,2,,72,0,14,,6,,35,B
20200402,SC,6995,669,1554,261,5441,408,31,5,241,,139,,,,,,B
20200402,SD,4382,350,165,36,4217,314,2,0,17,,5,,,,,57,A
20200402,TN,34611,2159,2845,162,31766,1997,32,8,263,656,63,,,,,220,A
20200402,TX,50679,2822,4669,672,46010,2150,70,12,,196,0,,,,,38,A
20200402,UT,21229,62,1074,62,20155,0,7,0,100,,9,,,,,,A
20200402,VA,17589,2245,1706,222,15883,2023,41,7,305,246,0,,145,,108,,A
20200402,VI,182,26,33,3,149,23,,0,,,0,,,,,25,
20200402,VT,4774,253,390,31,4384,222,17,1,45,29,0,,,,,15,A
20200402,WA,95292,4907,9201,332,86091,4575,310,28,,,0,,,,,,A
20200402,WI,22357,1717,2040,219,20317,1498,31,7,461,,63,,,,,,A
20200402,WV,5493,918,217,26,5276,892,2,1,1,,0,,,,,,B
20200402,WY,2589,241,150,20,2439,221,0,0,19,,1,,,,,31,A
20200401,AK,4603,890,133,14,4470,876,3,0,9,,2,,,,,,A
20200401,AL,7774,495,1077,96,6697,399,26,13,,,0,,,,,,B
20200401,AR,7938,1456,584,61,7354,1395,10,2,90,56,90,,,25,32,42,A
20200401,AS,3,0,0,0,3,0,0,0,,,0,,,,,,
20200401,AZ,21058,1687,1413,124,19645,1563,29,5,582,,48,,,,,,B
20200401,CA,29927,673,8155,673,21772,0,171,18,,1855,0,774,,,,,B
20200401,CO,16849,1485,2966,339,13883,1146,69,18,509,574,95,,,,,,A
20200401,CT,16600,443,3557,429,13043,14,85,16,,766,0,,,,,,A
20200401,DC,3848,91,586,91,3262,0,11,2,,,0,,,,,142,A
20200401,DE,4383,368,368,49,4015,319,13,1,,51,0,,,,,49,C
20200401,FL,66484,5861,6955,617,59529,5244,87,10,949,,126,,,,,,A
20200401,GA,20326,4145,4638,709,15688,3436,139,28,952,,119,,,,,,A
20200401,GU,483,43,77,8,406,35,3,1,,19,0,2,,,,9,
20200401,HI,8929,254,208,4,8721,250,1,1,13,,1,,6,,,58,A
20200401,IA,7853,468,549,52,7304,416,9,2,99,63,5,,,,,118,C
20200401,ID,6601,889,525,110,6076,779,9,2,46,49,1,,7,,,,A
20200401,IL,40384,5159,6980,986,33404,4173,141,42,,,0,,,,,,A
20200401,IN,14375,1002,2565,406,11810,596,65,16,,,0,,,,,,B
20200401,KS,5893,469,482,54,5411,415,10,1,114,,35,,,,,,B
20200401,KY,7556,746,591,111,6965,635,17,6,,,0,,,,,,A
20200401,LA,45776,6809,6424,1187,39352,5622,273,34,,1498,0,,,490,,,A
20200401,MA,51764,4803,7639,1118,44125,3685,187,34,682,,120,,,,,,B
20200401,MD,19218,2690,1985,325,17233,2365,52,9,522,,93,,,,,,A
20200401,ME,6432,41,344,41,6088,0,7,2,63,,6,,,,,80,A
20200401,MI,50197,5209,20246,1592,29951,3617,676,125,,,0,,,,,,B
20200401,MN,22853,1002,973,57,21880,945,17,5,122,54,10,27,27,,,,A
20200401,MO,17427,1486,1581,254,15846,1232,18,4,,,0,,,,,,C
20200401,MP,6,4,6,4,,0,,0,,,0,,,,,,
20200401,MS,4785,311,1073,136,3712,175,22,2,332,,121,,,,,,B
20200401,MT,4918,500,208,24,4710,476,5,1,17,,3,,,,,,A
20200401,NC,26243,3137,1584,86,24659,3051,10,2,,204,0,,,,,,A
20200401,ND,4493,236,142,16,4351,220,3,0,23,,2,,,,,34,B
20200401,NE,3685,582,210,38,3475,544,4,1,,,0,,,,,,A
20200401,NH,6400,673,415,101,5985,572,4,1,56,,11,,,,,56,B
20200401,NJ,52642,6869,22255,3559,30387,3310,355,88,,2000,0,,,,,,A
20200401,NM,13240,713,315,34,12925,679,5,1,,24,0,,,,,26,A
20200401,NV,12798,1004,1279,166,11519,838,45,8,,,0,,,,,,A
20200401,NY,220880,15694,83712,7917,137168,7777,1941,391,19929,12226,2844,3022,,,,6142,A
20200401,OH,29539,348,2547,348,26992,0,65,10,679,,94,,222,,,,B
20200401,OK,1967,173,719,154,1248,19,30,7,219,174,42,98,,,,,B
20200401,OR,13872,46,736,46,13136,0,18,0,154,132,0,,,40,,,A
20200401,PA,48232,5744,5805,962,42427,4782,74,11,620,,106,,,,,,A
20200401,PR,1695,261,286,47,1409,214,11,3,,,0,,,,,,A
20200401,RI,4857,745,668,100,4189,645,10,2,,60,0,14,,6,,35,B
20200401,SC,6326,627,1293,210,5033,417,26,4,102,,0,,,,,,B
20200401,SD,4032,315,129,21,3903,294,2,1,12,,0,,,,,51,A
20200401,TN,32452,5092,2683,444,29769,4648,24,1,200,486,25,,,,,137,A
20200401,TX,47857,4865,3997,731,43860,4134,58,17,,196,0,,,,,38,A
20200401,UT,21167,2654,1012,125,20155,2529,7,2,91,,18,,,,,,A
20200401,VA,15344,1943,1484,234,13860,1709,34,7,305,,140,,145,,108,,A
20200401,VI,156,0,30,0,126,0,,0,,,0,,,,,21,
20200401,VT,4521,252,359,39,4162,213,16,3,45,30,9,,,,,15,A
20200401,WA,90385,4717,8869,438,81516,4279,282,20,,,0,,,,,,A
20200401,WI,20640,1680,1821,236,18819,1444,24,8,398,,61,,,,,,A
20200401,WV,4575,432,191,29,4384,403,1,0,1,,0,,,,,,B
20200401,WY,2348,240,130,21,2218,219,0,0,18,,1,,,,,31,A
20200331,AK,3713,59,119,5,3594,54,3,0,7,,0,,,,,,A
20200331,AL,7279,726,981,122,6298,604,13,7,,,0,,,,,,B
20200331,AR,6482,747,523,50,5959,697,8,1,,64,0,,,23,,35,A
20200331,AS,3,3,0,0,3,3,0,0,,,0,,,,,,
20200331,AZ,19371,2612,1289,132,18082,2480,24,4,534,,56,,,,,,B
20200331,CA,29254,2258,7482,1035,21772,1223,153,20,,1617,0,657,,,,,B
20200331,CO,15364,0,2627,0,12737,0,51,0,414,503,0,,,,,,A
20200331,CT,16157,1557,3128,557,13029,1000,69,33,,608,0,,,,,,A
20200331,DC,3757,674,495,94,3262,580,9,0,,,0,,,,,121,A
20200331,DE,4015,1535,319,55,3696,1480,12,1,,57,0,,,,,22,C
20200331,FL,60623,6925,6338,865,54285,6060,77,14,823,,171,,,,,,A
20200331,GA,16181,3457,3929,1120,12252,2337,111,24,833,,126,,,,,,A
20200331,GU,440,30,69,11,371,19,2,1,,19,0,2,,,,7,
20200331,HI,8675,675,204,29,8471,646,,0,12,,0,,6,,,49,A
20200331,IA,7385,799,497,73,6888,726,7,1,94,61,20,,,,,33,C
20200331,ID,5712,1006,415,105,5297,901,7,1,45,45,6,,6,,,,A
20200331,IL,35225,4779,5994,937,29231,3842,99,26,,,0,,,,,,A
20200331,IN,13373,1715,2159,373,11214,1342,49,14,,,0,,,,,,B
20200331,KS,5424,502,428,60,4996,442,9,1,79,,13,,,,,,B
20200331,KY,6810,792,480,41,6330,751,11,2,,,0,,,,,,A
20200331,LA,38967,4934,5237,1212,33730,3722,239,54,,1355,0,,,438,,,A
20200331,MA,46961,4142,6521,868,40440,3274,153,29,562,,109,,,,,,B
20200331,MD,16528,1799,1660,247,14868,1552,43,8,429,,76,,,,,,A
20200331,ME,6391,2722,303,28,6088,2694,5,2,57,,8,,,,,68,A
20200331,MI,44988,4362,18654,1291,26334,3071,551,114,,,0,,,,,,B
20200331,MN,21851,1516,916,93,20935,1423,12,2,112,56,20,26,26,,,,A
20200331,MO,15941,1706,1327,296,14614,1410,14,1,,,0,,,,,,C
20200331,MP,2,0,2,0,,0,,0,,,0,,,,,,
20200331,MS,4474,638,937,90,3537,548,20,4,211,,16,,,,,,B
20200331,MT,4418,104,184,13,4234,91,4,0,14,,4,,,,,,A
20200331,NC,23106,2242,1498,191,21608,2051,8,2,,157,0,,,,,,A
20200331,ND,4257,420,126,17,4131,403,3,1,21,,2,,,,,30,B
20200331,NE,3103,374,172,27,2931,347,3,1,,,0,,,,,,A
20200331,NH,5727,27,314,0,5413,27,3,0,45,,0,,,,,,B
20200331,NJ,45773,3913,18696,2060,27077,1853,267,69,,2000,0,,,,,,A
20200331,NM,12527,1348,281,44,12246,1304,4,2,,22,0,,,,,26,A
20200331,NV,11794,579,1113,105,10681,474,37,5,,,0,,,,,,A
20200331,NY,205186,18718,75795,9298,129391,9420,1550,332,17085,10929,2507,2710,,,,4975,A
20200331,OH,29191,1916,2199,266,26992,1650,55,16,585,,110,,198,,,,B
20200331,OK,1794,106,565,84,1229,22,23,6,177,,24,83,,,,,B
20200331,OR,13826,943,690,84,13136,859,18,2,154,132,14,,,40,,,A
20200331,PA,42488,4624,4843,756,37645,3868,63,14,514,,128,,,,,,A
20200331,PR,1434,329,239,65,1195,264,8,2,,,0,,,,,,A
20200331,RI,4112,371,568,73,3544,298,8,4,,59,0,9,,6,,35,B
20200331,SC,5699,614,1083,158,4616,456,22,4,102,,0,,,,,,B
20200331,SD,3717,138,108,7,3609,131,1,0,12,,12,,,,,44,A
20200331,TN,27360,4056,2239,405,25121,3651,23,10,175,9,27,,,,,121,A
20200331,TX,42992,7112,3266,389,39726,6723,41,7,,196,0,,,,,38,A
20200331,UT,18513,2510,887,81,17626,2429,5,1,73,,73,,,,,,A
20200331,VA,13401,1363,1250,230,12151,1133,27,2,165,,29,,,,,,A
20200331,VI,156,0,30,0,126,0,,0,,,0,,,,,21,
20200331,VT,4269,258,320,27,3949,231,13,1,36,21,18,,,,,15,A
20200331,WA,85668,4706,8431,311,77237,4395,262,14,,,0,,,,,,A
20200331,WI,18960,1682,1585,163,17375,1519,16,2,337,,337,,,,,,A
20200331,WV,4143,1033,162,36,3981,997,1,0,1,,0,,,,,,B
20200331,WY,2108,174,109,15,1999,159,0,0,17,,0,,,,,26,A
20200330,AK,3654,320,114,12,3540,308,3,1,7,,1,,,,,,A
20200330,AL,6553,1563,859,53,5694,1510,6,2,,,0,,,,,,B
20200330,AR,5735,2282,473,47,5262,2235,7,1,,62,0,,,21,,29,A
20200330,AS,0,0,,0,,0,0,0,,,0,,,,,,
20200330,AZ,16759,2887,1157,238,15602,2649,20,3,478,,51,,,,,,B
20200330,CA,26996,739,6447,739,20549,0,133,10,,1432,0,597,,,,,B
20200330,CO,15364,2088,2627,566,12737,1522,51,7,414,358,140,,,,,,A
20200330,CT,14600,2700,2571,578,12029,2122,36,2,,517,0,,,,,,A
20200330,DC,3083,272,401,59,2682,213,9,4,,,0,,,,,106,A
20200330,DE,2480,2212,264,32,2216,2180,11,1,,45,0,,,,,9,C
20200330,FL,53698,10382,5473,1227,48225,9155,63,7,652,,58,,,,,,A
20200330,GA,12724,160,2809,158,9915,2,87,7,707,,41,,,,,,A
20200330,GU,410,20,58,2,352,18,1,0,,19,0,2,,,,7,
20200330,HI,8000,1000,175,24,7825,976,,0,12,,0,,,,,,A
20200330,IA,6586,1237,424,88,6162,1149,6,2,74,51,6,,,,,23,C
20200330,ID,4706,424,310,49,4396,375,6,1,39,42,3,,,,,,A
20200330,IL,30446,2684,5057,461,25389,2223,73,8,,,0,,,,,,A
20200330,IN,11658,1828,1786,272,9872,1556,35,3,,,0,,,,,,B
20200330,KS,4922,409,368,49,4554,360,8,2,66,,11,,,,,,B
20200330,KY,6018,477,439,45,5579,432,9,0,,,0,,,,,,A
20200330,LA,34033,6162,4025,485,30008,5677,185,34,,1185,0,,,385,,,A
20200330,MA,42819,3729,5653,797,37166,2932,124,25,453,,54,,,,,,B
20200330,MD,14729,1136,1413,174,13316,962,35,11,353,,76,,,,,,A
20200330,ME,3669,22,275,22,3394,0,3,0,49,,49,,,,,41,A
20200330,MI,40626,7425,17363,1579,23263,5846,437,86,,,0,,,,,,B
20200330,MN,20335,1044,823,98,19512,946,10,1,92,56,17,24,24,,,,A
20200330,MO,14235,1850,1031,193,13204,1657,13,3,,,0,,,,,,C
20200330,MP,2,0,2,0,,0,,0,,,0,,,,,,
20200330,MS,3836,518,847,89,2989,429,16,2,195,,-40,,,,,,B
20200330,MT,4314,17,171,17,4143,0,4,3,10,,2,,,,,,A
20200330,NC,20864,1919,1307,267,19557,1652,6,2,,137,0,,,,,,A
20200330,ND,3837,384,109,11,3728,373,2,1,19,,2,,,,,19,B
20200330,NE,2729,653,145,37,2584,616,2,0,,,0,,,,,,A
20200330,NH,5700,962,314,100,5386,862,3,1,45,,12,,,,,,B
20200330,NJ,41860,6258,16636,3250,25224,3008,198,37,,2000,0,,,,,,A
20200330,NM,11179,173,237,0,10942,173,2,0,,22,0,,,,,26,A
20200330,NV,11215,2065,1008,270,10207,1795,32,4,,,0,,,,,,A
20200330,NY,186468,14108,66497,6984,119971,7124,1218,253,14578,9517,1883,2352,,,,4204,A
20200330,OH,27275,6610,1933,280,25342,6330,39,10,475,,72,,163,,,,B
20200330,OK,1688,54,481,52,1207,2,17,1,153,,13,103,,,,,B
20200330,OR,12883,1457,606,58,12277,1399,16,3,140,132,11,,,39,,,A
20200330,PA,37864,4409,4087,693,33777,3716,49,11,386,,33,,,,,,A
20200330,PR,1105,137,174,47,931,90,6,1,,,0,,,,,,A
20200330,RI,3741,268,495,78,3246,190,4,1,,41,0,9,,6,,,B
20200330,SC,5085,1296,925,151,4160,1145,18,2,102,,0,,,,,,B
20200330,SD,3579,362,101,11,3478,351,1,0,,,0,,,,,34,A
20200330,TN,23304,2730,1834,297,21470,2433,13,6,148,,15,,,,,,A
20200330,TX,35880,10120,2877,325,33003,9795,34,0,,,0,,,,,38,A
20200330,UT,16003,2010,806,87,15197,1923,4,2,,,0,,,,,,A
20200330,VA,12038,1429,1020,130,11018,1299,25,3,136,,24,,,,,,A
20200330,VI,156,10,30,7,126,3,,0,,,0,,,,,,
20200330,VT,4011,272,293,37,3718,235,12,0,18,,0,,,,,,A
20200330,WA,80962,5150,8120,405,72842,4745,248,11,,,0,,,,,,A
20200330,WI,17278,-548,1422,146,15856,-694,14,1,,,0,,,,,,A
20200330,WV,3110,292,126,13,2984,279,1,1,1,,0,,,,,,B
20200330,WY,1934,294,94,8,1840,286,0,0,17,,2,,,,,24,A
20200329,AK,3334,413,102,17,3232,396,2,0,6,,1,,,,,,A
20200329,AL,4990,110,806,110,4184,0,4,1,,,0,,,,,,B
20200329,AR,3453,111,426,22,3027,89,6,1,,43,0,,,16,,28,A
20200329,AS,0,0,,0,,0,0,0,,,0,,,,,,
20200329,AZ,13872,5544,919,46,12953,5498,17,2,427,,41,,,,,,B
20200329,CA,26257,1065,5708,1065,20549,0,123,22,,1034,0,410,,,,,B
20200329,CO,13276,1600,2061,327,11215,1273,44,13,274,332,35,,,,,,A
20200329,CT,11900,3500,1993,702,9907,2798,34,7,,404,0,,,,,,A
20200329,DC,2811,296,342,38,2469,258,5,1,,,0,,,,,66,A
20200329,DE,268,18,232,18,36,0,10,1,,33,0,,,,,9,C
20200329,FL,43316,4187,4246,483,39070,3704,56,2,594,,68,,,,,,A
20200329,GA,12564,1513,2651,285,9913,1228,80,11,666,,49,,,,,,A
20200329,GU,390,36,56,1,334,35,1,0,,15,0,,,,,7,
20200329,HI,7000,2523,151,31,6849,2492,,0,12,,4,,,,,,A
20200329,IA,5349,676,336,38,5013,638,4,1,68,51,7,,,,,17,C
20200329,ID,4282,710,261,31,4021,679,5,1,36,35,11,,,,,,A
20200329,IL,27762,2271,4596,1105,23166,1166,65,18,,,0,,,,,,A
20200329,IN,9830,1423,1514,282,8316,1141,32,1,,,0,,,,,,B
20200329,KS,4513,581,319,58,4194,523,6,1,55,,28,,,,,,B
20200329,KY,5541,418,394,92,5147,326,9,1,,,0,,,,,,A
20200329,LA,27871,2710,3540,225,24331,2485,151,14,,1127,0,,,380,,,A
20200329,MA,39090,4017,4856,698,34234,3319,99,27,399,,49,,,,,,B
20200329,MD,13593,1085,1239,247,12354,838,24,7,277,,51,,,,,,D
20200329,ME,3647,42,253,42,3394,0,3,2,,,0,,,,,41,A
20200329,MI,33201,2434,15784,919,17417,1515,351,68,,,0,,,,,,B
20200329,MN,19291,1209,725,38,18566,1171,9,4,75,39,18,,17,,,243,A
20200329,MO,12385,1465,838,0,11547,1465,10,0,,,0,,,,,,C
20200329,MP,2,0,2,0,,0,,0,,,0,,,,,,
20200329,MS,3318,95,758,95,2560,0,14,1,235,,16,,,,,,B
20200329,MT,4297,912,154,25,4143,887,1,0,8,,1,,,,,,A
20200329,NC,18945,1418,1040,105,17905,1313,4,0,,91,0,,,,,,A
20200329,ND,3453,561,98,15,3355,546,1,0,17,,1,,,,,18,B
20200329,NE,2076,76,108,12,1968,64,2,0,,,0,,,,,,A
20200329,NH,4738,895,214,27,4524,868,2,0,33,,3,,,,,,B
20200329,NJ,35602,5092,13386,2262,22216,2830,161,21,,2000,0,,,,,,A
20200329,NM,11006,1619,237,46,10769,1573,2,1,,19,0,,,,,2,A
20200329,NV,9150,628,738,117,8412,511,28,3,,,0,,,,,,A
20200329,NY,172360,16426,59513,7195,112847,9231,965,237,12695,8503,2241,2037,,,,3572,A
20200329,OH,20665,247,1653,247,19012,0,29,4,403,,59,,139,,,,B
20200329,OK,1634,77,429,52,1205,25,16,1,140,,14,,,,,,A
20200329,OR,11426,1254,548,69,10878,1185,13,0,129,107,12,,,37,,,A
20200329,PA,33455,5450,3394,643,30061,4807,38,4,353,,37,,,,,,A
20200329,PR,968,129,127,27,841,102,5,2,,,0,,,,,,A
20200329,RI,3473,419,417,105,3056,314,3,3,,35,0,9,,6,,,B
20200329,SC,3789,842,774,235,3015,607,16,3,102,,0,,,,,,B
20200329,SD,3217,557,90,22,3127,535,1,0,,,0,,,,,29,A
20200329,TN,20574,2236,1537,164,19037,2072,7,1,133,,15,,,,,,A
20200329,TX,25760,500,2552,500,23208,0,34,7,,,0,,,,,,A
20200329,UT,13993,2681,719,117,13274,2564,2,0,,,0,,,,,,A
20200329,VA,10609,1443,890,151,9719,1292,22,5,112,,13,,,,,,A
20200329,VI,146,18,23,1,123,17,,0,,,0,,,,,,
20200329,VT,3739,313,256,22,3483,291,12,0,18,,0,,,,,,A
20200329,WA,75812,1833,7715,318,68097,1515,237,17,,,0,,,,,,A
20200329,WI,17826,1460,1276,142,16550,1318,13,0,,,0,,,,,,A
20200329,WV,2818,391,113,17,2705,374,0,0,1,,0,,,,,,B
20200329,WY,1640,83,86,4,1554,79,0,0,15,,1,,,,,20,A
20200328,AK,2921,533,85,16,2836,517,2,1,5,,2,,,,,,A
20200328,AL,4880,109,696,109,4184,0,3,0,,,0,,,,,,B
20200328,AR,3342,1416,404,23,2938,1393,5,2,,48,0,,,17,,24,A
20200328,AS,0,0,,0,,0,0,0,,,0,,,,,,
20200328,AZ,8328,137,873,137,7455,0,15,2,386,,43,,,,,,B
20200328,CA,25192,3933,4643,764,20549,3169,101,23,,1034,0,410,,,,,B
20200328,CO,11676,1554,1734,304,9942,1250,31,7,239,307,55,,,,,,A
20200328,CT,8400,0,1291,0,7109,0,27,0,,173,0,,,,,,A
20200328,DC,2515,351,304,37,2211,314,4,1,,,0,,,,,51,A
20200328,DE,250,51,214,51,36,0,9,4,,31,0,,,,,9,C
20200328,FL,39129,8178,3763,998,35366,7180,54,20,526,,70,,,,,,A
20200328,GA,11051,1186,2366,365,8685,821,69,5,617,,51,,,,,,A
20200328,GU,354,4,55,4,299,0,1,0,,15,0,,,,,7,
20200328,HI,4477,14,120,14,4357,0,,0,8,,1,,,,,,A
20200328,IA,4673,698,298,63,4375,635,3,0,61,46,11,,,,,15,C
20200328,ID,3572,715,230,41,3342,674,4,1,25,37,25,,,,,,A
20200328,IL,25491,3949,3491,465,22000,3484,47,13,,,0,,,,,,A
20200328,IN,8407,1471,1232,251,7175,1220,31,7,,,0,,,,,,B
20200328,KS,3932,501,261,59,3671,442,5,1,27,,0,,,,,,B
20200328,KY,5123,1107,302,54,4821,1053,8,2,,,0,,,,,,A
20200328,LA,25161,3802,3315,569,21846,3233,137,18,,927,0,,,336,,,A
20200328,MA,35073,5678,4158,1007,30915,4671,72,15,350,,131,,,,,,B
20200328,MD,12508,11640,992,218,11516,11422,17,7,226,,53,,,,,,D
20200328,ME,3605,43,211,43,3394,0,1,0,,,0,,,,,36,A
20200328,MI,30767,2828,14865,1066,15902,1762,283,71,,,0,,,,,,B
20200328,MN,18082,3837,687,47,17395,3790,5,1,57,30,6,,17,,,215,A
20200328,MO,10920,9882,838,169,10082,9713,10,2,,,0,,,,,,C
20200328,MP,2,2,2,2,,0,,0,,,0,,,,,,
20200328,MS,3223,84,663,84,2560,0,13,5,219,,34,,,,,,B
20200328,MT,3385,687,129,21,3256,666,1,1,7,,0,,,,,,A
20200328,NC,17527,2391,935,172,16592,2219,4,1,,87,0,,,,,,A
20200328,ND,2892,400,83,18,2809,382,1,1,16,,3,,,,,16,B
20200328,NE,2000,154,96,11,1904,143,2,2,,,0,,,,,,A
20200328,NH,3843,290,187,29,3656,261,2,1,30,,5,,,,,,B
20200328,NJ,30510,5138,11124,2299,19386,2839,140,32,,2000,0,,,,,,A
20200328,NM,9387,874,191,55,9196,819,1,0,,17,0,,,,,,A
20200328,NV,8522,1826,621,86,7901,1740,25,4,,,0,,,,,,A
20200328,NY,155934,10181,52318,7683,103616,2498,728,209,10454,7328,1722,1755,,,,2726,A
20200328,OH,20418,269,1406,269,19012,0,25,6,344,,68,,123,,,,B
20200328,OK,1557,151,377,55,1180,96,15,7,126,,21,,,,,,A
20200328,OR,10172,1248,479,65,9693,1183,13,1,117,107,15,,,31,,,A
20200328,PA,28005,4771,2751,533,25254,4238,34,12,316,,75,,,,,,A
20200328,PR,839,241,100,21,739,220,3,0,,,0,,,,,,A
20200328,RI,3054,304,312,64,2742,240,,0,,29,0,9,,6,,,B
20200328,SC,2947,184,539,83,2408,101,13,4,102,,0,,,,,,B
20200328,SD,2660,215,68,10,2592,205,1,0,,,0,,,,,26,A
20200328,TN,18338,2247,1373,170,16965,2077,6,0,118,,15,,,,,,A
20200328,TX,25260,1594,2052,321,23208,1273,27,4,,,0,,,,,,A
20200328,UT,11312,2068,602,122,10710,1946,2,0,,,0,,,,,,A
20200328,VA,9166,1829,739,135,8427,1694,17,3,99,,16,,,,,,A
20200328,VI,128,54,22,3,106,51,,0,,,0,,,,,,
20200328,VT,3426,345,234,21,3192,324,12,2,18,,0,,,,,,A
20200328,WA,73979,2601,7397,321,66582,2280,220,21,,,0,,,,,,A
20200328,WI,16366,2257,1134,165,15232,2092,13,0,,,0,,,,,,A
20200328,WV,2427,572,96,20,2331,552,0,0,1,,0,,,,,,B
20200328,WY,1557,276,82,12,1475,264,0,0,14,,3,,,,,18,A
20200327,AK,2388,528,69,10,2319,518,1,0,3,,0,,,,,,A
20200327,AL,4771,672,587,81,4184,591,3,2,,,0,,,,,,B
20200327,AR,1926,87,381,46,1545,41,3,0,,48,0,,,17,,19,A
20200327,AS,0,0,,0,,0,0,0,,,0,,,,,,
20200327,AZ,8191,7267,736,159,7455,7108,13,5,343,,40,,,,,,B
20200327,CA,21259,873,3879,873,17380,0,78,13,,746,0,200,,,,,B
20200327,CO,10122,2058,1430,344,8692,1714,24,5,184,278,36,,,,,,A
20200327,CT,8400,1763,1291,279,7109,1484,27,6,,173,0,,,,,,A
20200327,DC,2164,307,267,36,1897,271,3,0,,,0,,,,,49,A
20200327,DE,199,33,163,33,36,0,5,2,,15,0,,,,,9,C
20200327,FL,30951,4855,2765,410,28186,4445,34,6,456,,50,,,,,,A
20200327,GA,9865,939,2001,476,7864,463,64,16,566,,93,,,,,,A
20200327,GU,350,42,51,6,299,36,1,0,,13,0,,,,,,
20200327,HI,4463,11,106,11,4357,0,,0,7,,2,,,,,,A
20200327,IA,3975,1218,235,56,3740,1162,3,2,50,32,4,,,,,18,C
20200327,ID,2857,669,189,66,2668,603,3,3,,31,0,,,,,,A
20200327,IL,21542,4911,3026,488,18516,4423,34,8,,,0,,,,,,A
20200327,IN,6936,2285,981,336,5955,1949,24,7,,,0,,,,,,B
20200327,KS,3431,394,202,34,3229,360,4,1,27,,27,,,,,,B
20200327,KY,4016,716,248,50,3768,666,6,2,,,0,,,,,,A
20200327,LA,21359,3330,2746,441,18613,2889,119,36,,773,0,,,270,,,A
20200327,MA,29395,5750,3151,833,26244,4917,57,15,219,,0,,,,,,B
20200327,MD,868,194,774,194,94,0,10,3,173,,41,,,,,25,D
20200327,ME,3562,13,168,13,3394,0,1,1,,,0,,,,,24,A
20200327,MI,27939,3734,13799,1324,14140,2410,212,53,,,0,,,,,,B
20200327,MN,14245,1076,640,75,13605,1001,4,2,51,34,10,,17,,,176,A
20200327,MO,1038,167,669,167,369,0,8,0,,,0,,,,,,C
20200327,MP,0,0,0,0,,0,0,0,,,0,,,,,,
20200327,MS,3139,363,579,94,2560,269,8,2,185,,35,,,,,,B
20200327,MT,2698,499,108,37,2590,462,,0,7,,6,,,,,,A
20200327,NC,15136,2226,763,127,14373,2099,3,1,,77,0,,,,,,A
20200327,ND,2492,401,65,13,2427,388,0,0,13,,3,,,,,15,B
20200327,NE,1846,189,85,12,1761,177,0,0,,,0,,,,,,A
20200327,NH,3553,415,158,21,3395,394,1,0,25,,6,,,,,,B
20200327,NJ,25372,4835,8825,1949,16547,2886,108,27,,2000,0,,,,,,A
20200327,NM,8513,720,136,24,8377,696,1,0,,,0,,,,,,A
20200327,NV,6696,1579,535,115,6161,1464,21,4,,,0,,,,,,A
20200327,NY,145753,23649,44635,7377,101118,16272,519,134,8732,6481,1811,1583,,,,2045,A
20200327,OH,20149,2833,1137,270,19012,2563,19,4,276,,53,,107,,,,B
20200327,OK,1406,200,322,74,1084,126,8,1,105,,19,,,,,,A
20200327,OR,8924,1644,414,87,8510,1557,12,1,102,91,12,,,31,,,A
20200327,PA,23234,5106,2218,531,21016,4575,22,6,241,,241,,,,,,A
20200327,PR,598,157,79,15,519,142,3,1,,,0,,,,,,A
20200327,RI,2750,233,248,31,2502,202,,0,,28,0,9,,6,,,B
20200327,SC,2763,0,456,0,2307,0,9,0,102,,0,,,,,,B
20200327,SD,2445,426,58,12,2387,414,1,0,,,0,,,,,21,A
20200327,TN,16091,1182,1203,246,14888,936,6,3,103,,27,,,,,,A
20200327,TX,23666,2242,1731,335,21935,1907,23,5,,,0,,,,,,A
20200327,UT,9244,1534,480,78,8764,1456,2,1,,,0,,,,,,A
20200327,VA,7337,1148,604,144,6733,1004,14,1,83,,18,,,,,,A
20200327,VI,74,2,19,2,55,0,,0,,,0,,,,,,
20200327,VT,3081,152,213,28,2868,124,10,1,18,,18,,,,,,A
20200327,WA,71378,4360,7076,376,64302,3984,199,16,,,0,,,,,,A
20200327,WI,14109,1720,969,163,13140,1557,13,5,,,0,,,,,,A
20200327,WV,1855,773,76,25,1779,748,0,0,1,,0,,,,,,B
20200327,WY,1281,176,70,17,1211,159,0,0,11,,11,,,,,17,A
20200326,AK,1860,169,59,17,1801,152,1,0,3,,2,,,,,,A
20200326,AL,4099,1287,506,223,3593,1064,1,1,,,0,,,,,,C
20200326,AR,1839,122,335,55,1504,67,3,1,,41,0,,,13,,13,A
20200326,AS,0,0,,0,,0,0,0,,,0,,,,,,
20200326,AZ,924,151,577,127,347,24,8,2,303,,39,,,,,,B
20200326,CA,20386,2110,3006,651,17380,1459,65,12,,,0,,,,,,B
20200326,CO,8064,363,1086,174,6978,189,19,8,148,230,64,,,,,,A
20200326,CT,6637,739,1012,137,5625,602,21,2,,125,0,,,,,,A
20200326,DC,1857,251,231,48,1626,203,3,1,,,0,,,,,21,A
20200326,DE,166,15,130,15,36,0,3,1,,13,0,,,,,4,C
20200326,FL,26096,9040,2355,673,23741,8367,28,6,406,,90,,,,,,A
20200326,GA,8926,2747,1525,278,7401,2469,48,8,473,,79,,,,,,A
20200326,GU,308,38,45,8,263,30,1,0,,11,0,,,,,,
20200326,HI,4452,5,95,5,4357,0,,0,5,,-1,,,,,,A
20200326,IA,2757,34,179,34,2578,0,1,0,46,31,10,,,,,15,C
20200326,ID,2188,228,123,50,2065,178,0,0,,34,0,,,,,,A
20200326,IL,16631,2422,2538,673,14093,1749,26,7,,,0,,,,,,A
20200326,IN,4651,1295,645,168,4006,1127,17,3,,,-1,,,,,,B
20200326,KS,3037,551,168,42,2869,509,3,0,,,0,,,,,,B
20200326,KY,3300,278,198,41,3102,237,4,0,,,0,,,,,,A
20200326,LA,18029,6578,2305,510,15724,6068,83,18,,676,0,,,239,,,A
20200326,MA,23645,3827,2318,579,21327,3248,42,9,219,,116,,,,,,B
20200326,MD,674,157,580,157,94,0,7,2,132,,132,,,,,,D
20200326,ME,3549,223,155,6,3394,217,,0,,,0,,,,,16,A
20200326,MI,24205,4028,12475,1140,11730,2888,159,48,,,0,,,,,,D
20200326,MN,13169,1479,565,63,12604,1416,2,1,41,31,6,,,,,,A
20200326,MO,871,146,502,146,369,0,8,0,,,0,,,,,,C
20200326,MP,0,0,0,0,,0,0,0,,,0,,,,,,
20200326,MS,2776,833,485,108,2291,725,6,4,150,,33,,,,,,B
20200326,MT,2199,198,71,18,2128,180,,0,1,,1,,,,,,C
20200326,NC,12910,2421,636,132,12274,2289,2,1,,29,0,,,,,,A
20200326,ND,2091,318,52,13,2039,305,0,0,10,,2,,,,,,B
20200326,NE,1657,292,73,12,1584,280,0,0,,,0,,,,,,A
20200326,NH,3138,674,137,29,3001,645,1,0,19,,6,,,,,,B
20200326,NJ,20537,5683,6876,2474,13661,3209,81,19,,1080,0,,,,,,B
20200326,NM,7793,951,112,12,7681,939,1,0,,,0,,,,,,A
20200326,NV,5117,545,420,99,4697,446,17,4,,,0,,,,,,A
20200326,NY,122104,18625,37258,6447,84846,12178,385,100,6921,5327,1795,1290,,,,,B
20200326,OH,17316,2552,867,163,16449,2389,15,5,223,,41,,91,,,,B
20200326,OK,1206,237,248,84,958,153,7,2,86,,27,,,,,,A
20200326,OR,7280,2721,327,118,6953,2603,11,3,90,,29,,,,,,A
20200326,PA,18128,5808,1687,560,16441,5248,16,5,,,0,,,,,,A
20200326,PR,441,73,64,13,377,60,2,0,,,0,,,,,,A
20200326,RI,2517,217,217,41,2300,176,,0,,23,0,9,,6,,,B
20200326,SC,2763,36,456,32,2307,4,9,2,102,,0,,,,,,B
20200326,SD,2019,1159,46,5,1973,1154,1,0,,,0,,,,,16,A
20200326,TN,14909,3113,957,173,13952,2940,3,0,76,,23,,,,,,A
20200326,TX,21424,7930,1396,422,20028,7508,18,6,,,0,,,,,,A
20200326,UT,7710,873,402,56,7308,817,1,0,,,0,,,,,,A
20200326,VA,6189,819,460,69,5729,750,13,4,65,,6,,,,,,A
20200326,VI,72,0,17,0,55,0,,0,,,0,,,,,,
20200326,VT,2929,959,185,25,2744,934,9,1,,,0,,,,,,A
20200326,WA,67018,4471,6700,371,60318,4100,183,24,,,0,,,,,,A
20200326,WI,12389,1633,806,139,11583,1494,8,1,,,0,,,,,,A
20200326,WV,1082,284,51,12,1031,272,0,0,1,,0,,,,,,B
20200326,WY,1105,107,53,9,1052,98,,0,,,0,,,,,12,A
20200325,AK,1691,669,42,6,1649,663,1,1,1,,1,,,,,,A
20200325,AL,2812,491,283,68,2529,423,0,0,,,0,,,,,,C
20200325,AR,1717,552,280,62,1437,490,2,2,,22,0,,,4,,11,A
20200325,AS,0,0,,0,,0,0,0,,,0,,,,,,
20200325,AZ,773,103,450,93,323,10,6,1,264,,45,,,,,,B
20200325,CA,18276,2722,2355,253,15921,2469,53,13,,,0,,,,,,B
20200325,CO,7701,1477,912,192,6789,1285,11,4,84,152,12,,,,,,A
20200325,CT,5898,598,875,257,5023,341,19,7,,113,0,,,,,,A
20200325,DC,1606,274,183,46,1423,228,2,0,,,0,,,,,,A
20200325,DE,151,24,115,24,36,0,2,1,,11,0,,,,,,C
20200325,FL,17056,2517,1682,270,15374,2247,22,4,316,,57,,,,,,A
20200325,GA,6179,695,1247,221,4932,474,40,8,394,,394,,,,,,A
20200325,GU,270,37,37,5,233,32,1,0,,10,0,,,,,,
20200325,HI,4447,781,90,13,4357,768,,0,6,,2,,,,,,A
20200325,IA,2723,284,145,21,2578,263,1,1,36,23,9,,,,,,C
20200325,ID,1960,23,73,23,1887,0,0,0,,,0,,,,,,A
20200325,IL,14209,2740,1865,330,12344,2410,19,3,,,0,,,,,,A
20200325,IN,3356,425,477,112,2879,313,14,2,1,,0,,,,,,B
20200325,KS,2486,302,126,28,2360,274,3,1,,,0,,,,,,B
20200325,KY,3022,1136,157,33,2865,1103,4,0,,,0,,,,,,A
20200325,LA,11451,2848,1795,407,9656,2441,65,19,,491,0,,,163,,,A
20200325,MA,19818,6044,1739,679,18079,5365,33,7,103,,9,,,,,,B
20200325,MD,517,74,423,74,94,0,5,0,,,0,,,,,,D
20200325,ME,3326,187,149,24,3177,163,,0,,,0,,,,,7,A
20200325,MI,20177,3033,11335,1180,8842,1853,111,25,,,0,,,,,,D
20200325,MN,11690,5696,502,58,11188,5638,1,0,35,26,14,,,,,121,A
20200325,MO,725,173,356,173,369,0,8,5,,,0,,,,,,C
20200325,MP,0,0,0,0,,0,0,0,,,0,,,,,,
20200325,MS,1943,71,377,57,1566,14,2,1,117,,31,,,,,,B
20200325,MT,2001,312,53,7,1948,305,,0,,,0,,,,,,C
20200325,NC,10489,1950,504,106,9985,1844,1,1,,29,0,,,,,,A
20200325,ND,1773,285,39,5,1734,280,0,0,8,,3,,,,,,B
20200325,NE,1365,338,61,9,1304,329,0,0,,,0,,,,,,A
20200325,NH,2464,916,108,7,2356,909,1,0,13,,2,,,,,,B
20200325,NJ,14854,2854,4402,727,10452,2127,62,18,,,0,,,,,,B
20200325,NM,6842,869,100,17,6742,852,1,1,,,0,,,,,,A
20200325,NV,4572,340,321,43,4251,297,13,0,,,0,,,,,,A
20200325,NY,103479,12209,30811,5146,72668,7063,285,75,5126,4079,1085,,,,,,B
20200325,OH,14764,14060,704,140,14060,13920,10,2,182,,37,,74,,,,B
20200325,OK,969,128,164,58,805,70,5,2,59,,34,,,,,,A
20200325,OR,4559,0,209,0,4350,0,8,0,61,,0,,,,,,A
20200325,PA,12320,2826,1127,276,11193,2550,11,4,,,0,,,,,,A
20200325,PR,368,61,51,12,317,49,2,0,,,0,,,,,,A
20200325,RI,2300,201,176,28,2124,173,,0,,15,0,,,,,,B
20200325,SC,2727,417,424,126,2303,291,7,2,102,,102,,,,,,B
20200325,SD,860,40,41,11,819,29,1,0,,,0,,,,,,A
20200325,TN,11796,612,784,117,11012,495,3,1,53,,53,,,,,,A
20200325,TX,13494,2327,974,564,12520,1763,12,3,,,0,,,,,,A
20200325,UT,6837,1014,346,47,6491,967,1,0,,,0,,,,,,A
20200325,VA,5370,900,391,101,4979,799,9,2,59,,14,,,,,,A
20200325,VI,72,55,17,0,55,55,,0,,,0,,,,,,
20200325,VT,1970,276,160,35,1810,241,8,1,,,0,,,,,,A
20200325,WA,62547,5007,6329,406,56218,4601,159,13,,,0,,,,,,A
20200325,WI,10756,1994,667,142,10089,1852,7,2,,,0,,,,,,A
20200325,WV,798,168,39,19,759,149,0,0,1,,0,,,,,,B
20200325,WY,998,259,44,15,954,244,,0,,,0,,,,,7,A
20200324,AK,1022,54,36,14,986,40,0,0,0,,0,,,,,,A
20200324,AL,2321,489,215,48,2106,441,0,0,,,0,,,,,,C
20200324,AR,1165,85,218,44,947,41,0,0,,22,0,,,,,,A
20200324,AS,0,0,,0,,0,0,0,,,0,,,,,,
20200324,AZ,670,96,357,92,313,4,5,3,219,,30,,,,,,B
20200324,CA,15554,1254,2102,369,13452,885,40,13,,,0,,,,,,B
20200324,CO,6224,788,720,129,5504,659,7,1,72,116,14,,,,,,A
20200324,CT,5300,800,618,203,4682,597,12,2,,71,0,,,,,,A
20200324,DC,1332,103,137,21,1195,82,2,0,,,0,,,,,,A
20200324,DE,127,23,91,23,36,0,1,1,,,0,,,,,,C
20200324,FL,14539,2305,1412,241,13127,2064,18,4,259,,42,,,,,,A
20200324,GA,5484,415,1026,254,4458,161,32,7,,,0,,,,,,A
20200324,GU,233,43,32,3,201,40,1,0,,5,0,,,,,,
20200324,HI,3666,655,77,21,3589,634,,0,4,,4,,,,,,A
20200324,IA,2439,291,124,19,2315,272,,0,27,,27,,,,,,C
20200324,ID,1937,581,50,3,1887,578,0,0,,,0,,,,,,A
20200324,IL,11469,1613,1535,262,9934,1351,16,4,,,0,,,,,,A
20200324,IN,2931,971,365,106,2566,865,12,5,1,,0,,,,,,B
20200324,KS,2184,1685,98,16,2086,1669,2,0,,,0,,,,,,B
20200324,KY,1886,20,124,20,1762,0,4,1,,,0,,,,,,A
20200324,LA,8603,2655,1388,216,7215,2439,46,12,,271,0,,,,,,A
20200324,MA,13774,4833,1060,382,12714,4451,26,9,94,,15,,,,,,B
20200324,MD,443,61,349,61,94,0,5,1,,,0,,,,,,D
20200324,ME,3139,241,125,18,3014,223,,0,,,0,,,,,,A
20200324,MI,17144,2235,10155,1093,6989,1142,86,29,,,0,,,,,,D
20200324,MN,5994,1090,444,51,5550,1039,1,0,21,,4,,,,,,A
20200324,MO,552,0,183,0,369,0,3,0,,,0,,,,,,C
20200324,MP,0,0,0,0,,0,0,0,,,0,,,,,,
20200324,MS,1872,480,320,71,1552,409,1,0,86,,53,,,,,,B
20200324,MT,1689,509,46,12,1643,497,,0,,,0,,,,,,C
20200324,NC,8539,101,398,101,8141,0,0,0,,,0,,,,,,A
20200324,ND,1488,105,34,4,1454,101,0,0,5,,1,,,,,,B
20200324,NE,1027,621,52,2,975,619,0,0,,,0,,,,,,A
20200324,NH,1548,96,101,23,1447,73,1,1,11,,11,,,,,,B
20200324,NJ,12000,8797,3675,831,8325,7966,44,17,,,0,,,,,,B
20200324,NM,5973,587,83,18,5890,569,,0,,,0,,,,,,A
20200324,NV,4232,497,278,33,3954,464,13,5,,,0,,,,,,A
20200324,NY,91270,12981,25665,4790,65605,8191,210,96,4041,3343,916,,,,,,B
20200324,OH,704,122,564,122,140,0,8,2,145,,41,,,,,,D
20200324,OK,841,66,106,25,735,41,3,1,25,,10,,,,,,A
20200324,OR,4559,719,209,18,4350,701,8,3,61,,5,,,,,,A
20200324,PA,9494,2255,851,207,8643,2048,7,1,,,0,,,,,,A
20200324,PR,307,87,39,8,268,79,2,0,,,0,,,,,,A
20200324,RI,2099,257,148,19,1951,238,,0,,,0,,,,,,B
20200324,SC,2310,546,298,0,2012,546,5,0,,,0,,,,,,B
20200324,SD,820,30,30,2,790,28,1,0,,,0,,,,,,A
20200324,TN,11184,7297,667,52,10517,7245,2,0,,,0,,,,,,A
20200324,TX,11167,1112,410,58,10757,1054,9,1,,,0,,,,,,A
20200324,UT,5823,776,299,42,5524,734,1,0,,,0,,,,,,A
20200324,VA,4470,773,290,36,4180,737,7,1,45,,7,,,,,,A
20200324,VI,17,0,17,0,,0,,0,,,0,,,,,,
20200324,VT,1694,173,125,28,1569,145,7,2,,,0,,,,,,A
20200324,WA,57540,5227,5923,355,51617,4872,146,9,,,0,,,,,,A
20200324,WI,8762,1246,525,59,8237,1187,5,0,,,0,,,,,,A
20200324,WV,630,170,20,4,610,166,0,0,1,,0,,,,,,B
20200324,WY,739,121,29,3,710,118,,0,,,0,,,,,,A
20200323,AK,968,0,22,0,946,0,0,0,0,,0,,,,,,A
20200323,AL,1832,230,167,29,1665,201,0,0,,,0,,,,,,C
20200323,AR,1080,204,174,9,906,195,0,0,,13,0,,,,,,A
20200323,AS,0,0,,0,,0,0,0,,,0,,,,,,
20200323,AZ,574,140,265,113,309,27,2,0,189,,44,,,,,,B
20200323,CA,14300,1460,1733,197,12567,1263,27,0,,,0,,,,,,B
20200323,CO,5436,886,591,116,4845,770,6,1,58,74,9,,,,,,A
20200323,CT,4500,1400,415,192,4085,1208,10,5,,54,0,,,,,,A
20200323,DC,1229,174,116,18,1113,156,2,1,,,0,,,,,,A
20200323,DE,104,12,68,12,36,0,0,0,,,0,,,,,,C
20200323,FL,12234,3414,1171,341,11063,3073,14,1,217,,32,,,,,,A
20200323,GA,5069,1049,772,172,4297,877,25,2,,,0,,,,,,A
20200323,GU,190,37,29,2,161,35,1,0,,,0,,,,,,
20200323,HI,3011,2700,56,8,2955,2692,,0,,,0,,,,,,A
20200323,IA,2148,843,105,15,2043,828,,0,,,0,,,,,,C
20200323,ID,1356,139,47,5,1309,134,0,0,,,0,,,,,,A
20200323,IL,9856,1536,1273,224,8583,1312,12,3,,,0,,,,,,A
20200323,IN,1960,466,259,58,1701,408,7,1,1,,0,,,,,,B
20200323,KS,499,18,82,18,417,0,2,0,,,0,,,,,,B
20200323,KY,1866,295,104,5,1762,290,3,0,,,0,,,,,,A
20200323,LA,5948,2450,1172,335,4776,2115,34,14,,,0,,,,,,B
20200323,MA,8941,2918,678,131,8263,2787,17,6,79,,8,,,,,,B
20200323,MD,382,44,288,44,94,0,4,0,,,0,,,,,,D
20200323,ME,2898,545,107,18,2791,527,,0,,,0,,,,,,A
20200323,MI,14909,2296,9062,1240,5847,1056,57,21,,,0,,,,,,D
20200323,MN,4904,44,393,44,4511,0,1,0,17,,5,,,,,,A
20200323,MO,552,93,183,93,369,0,3,0,,,0,,,,,,C
20200323,MP,0,0,0,0,,0,0,0,,,0,,,,,,
20200323,MS,1392,71,249,42,1143,29,1,0,33,,0,,,,,,B
20200323,MT,1180,3,34,3,1146,0,,0,,,0,,,,,,C
20200323,NC,8438,2000,297,42,8141,1958,0,0,,,0,,,,,,A
20200323,ND,1383,95,30,2,1353,93,0,0,4,,1,,,,,,B
20200323,NE,406,2,50,2,356,0,0,0,,,0,,,,,,A
20200323,NH,1452,199,78,13,1374,186,,0,,,0,,,,,,B
20200323,NJ,3203,962,2844,930,359,32,27,7,,,0,,,,,,B
20200323,NM,5386,607,65,8,5321,599,,0,,,0,,,,,,A
20200323,NV,3735,1097,245,55,3490,1042,8,1,,,0,,,,,,A
20200323,NY,78289,16888,20875,5707,57414,11181,114,0,3125,2629,771,,,,,,B
20200323,OH,582,91,442,91,140,0,6,3,104,,21,,,,,,D
20200323,OK,775,39,81,14,694,25,2,0,15,,4,,,,,,A
20200323,OR,3840,815,191,30,3649,785,5,1,56,,13,,,,,,A
20200323,PA,7239,1796,644,165,6595,1631,6,4,,,0,,,,,,A
20200323,PR,220,14,31,8,189,6,2,1,,,0,,,,,,A
20200323,RI,1842,182,129,16,1713,166,,0,,,0,,,,,,B
20200323,SC,1764,103,298,103,1466,0,5,2,,,0,,,,,,A
20200323,SD,790,29,28,7,762,22,1,0,,,0,,,,,,A
20200323,TN,3887,110,615,110,3272,0,2,2,,,0,,,,,,B
20200323,TX,10055,1299,352,18,9703,1281,8,3,,,0,,,,,,A
20200323,UT,5047,1358,257,76,4790,1282,1,0,,,0,,,,,,A
20200323,VA,3697,360,254,35,3443,325,6,3,38,,6,,,,,,A
20200323,VI,17,11,17,11,,0,,0,,,0,,,,,,
20200323,VT,1521,241,97,21,1424,220,5,3,,,0,,,,,,A
20200323,WA,52313,5303,5568,447,46745,4856,137,11,,,0,,,,,,A
20200323,WI,7516,861,466,41,7050,820,5,1,,,0,,,,,,A
20200323,WV,460,63,16,4,444,59,0,0,1,,0,,,,,,B
20200323,WY,618,156,26,2,592,154,,0,,,0,,,,,,A
20200322,AK,968,196,22,8,946,188,0,0,0,,0,,,,,,
20200322,AL,1602,1450,138,14,1464,1436,0,0,,,0,,,,,,
20200322,AR,876,191,165,47,711,144,0,0,,13,0,,,,,,
20200322,AS,0,0,,0,,0,0,0,,,0,,,,,,
20200322,AZ,434,90,152,48,282,42,2,1,145,,17,,,,,,
20200322,CA,12840,312,1536,257,11304,55,27,3,,,0,,,,,,
20200322,CO,4550,870,475,112,4075,758,5,1,49,56,5,,,,,,
20200322,CT,3100,800,223,29,2877,771,5,1,,43,0,,,,,,
20200322,DC,1055,472,98,21,957,451,1,0,,,0,,,,,,
20200322,DE,92,11,56,11,36,0,0,0,,,0,,,,,,
20200322,FL,8820,1583,830,172,7990,1411,13,1,185,,27,,,,,,
20200322,GA,4020,956,600,93,3420,863,23,9,,,0,,,,,,
20200322,GU,153,30,27,12,126,18,1,1,,,0,,,,,,
20200322,HI,311,150,48,11,263,139,,0,,,0,,,,,,
20200322,IA,1305,188,90,22,1215,166,,0,,,0,,,,,,
20200322,ID,1217,306,42,11,1175,295,0,0,,,0,,,,,,
20200322,IL,8320,2079,1049,296,7271,1783,9,3,,,0,,,,,,
20200322,IN,1494,661,201,75,1293,586,6,2,1,,0,,,,,,
20200322,KS,481,9,64,9,417,0,2,0,,,0,,,,,,
20200322,KY,1571,803,99,45,1472,758,3,1,,,0,,,,,,
20200322,LA,3498,738,837,257,2661,481,20,4,,,0,,,,,,
20200322,MA,6023,798,547,121,5476,677,11,4,71,,10,,,,,,
20200322,MD,338,54,244,54,94,0,4,1,,,0,,,,,,
20200322,ME,2353,16,89,16,2264,0,,0,,,0,,,,,,
20200322,MI,12613,1504,7822,799,4791,705,36,13,,,0,,,,,,
20200322,MN,4860,581,349,22,4511,559,1,0,12,,12,,,,,,
20200322,MO,459,17,90,17,369,0,3,0,,,0,,,,,,
20200322,MP,0,0,0,0,,0,0,0,,,0,,,,,,
20200322,MS,1321,486,207,67,1114,419,1,0,33,,33,,,,,,
20200322,MT,1177,11,31,11,1146,0,,0,,,0,,,,,,
20200322,NC,6438,1162,255,71,6183,1091,0,0,,,0,,,,,,
20200322,ND,1288,119,28,0,1260,119,0,0,3,,0,,,,,,
20200322,NE,404,10,48,10,356,0,0,0,,,0,,,,,,
20200322,NH,1253,225,65,10,1188,215,,0,,,0,,,,,,
20200322,NJ,2241,620,1914,587,327,33,20,4,,,0,,,,,,
20200322,NM,4779,951,57,0,4722,951,,0,,,0,,,,,,
20200322,NV,2638,130,190,66,2448,64,7,2,,,0,,,,,,
20200322,NY,61401,15964,15168,4812,46233,11152,114,70,2354,2043,823,,,,,,
20200322,OH,491,104,351,104,140,0,3,0,83,,25,,,,,,
20200322,OK,736,123,67,14,669,109,2,1,11,,1,,,,,,
20200322,OR,3025,908,161,47,2864,861,4,1,43,,43,,,,,,
20200322,PA,5443,1306,479,108,4964,1198,2,0,,,0,,,,,,
20200322,PR,206,42,23,2,183,40,1,1,,,0,,,,,,
20200322,RI,1660,288,113,25,1547,263,,0,,,0,,,,,,
20200322,SC,1661,254,195,43,1466,211,3,2,,,0,,,,,,
20200322,SD,761,56,21,7,740,49,1,0,,,0,,,,,,
20200322,TN,3777,134,505,134,3272,0,,0,,,0,,,,,,
20200322,TX,8756,2234,334,30,8422,2204,5,0,,,0,,,,,,
20200322,UT,3689,1129,181,45,3508,1084,1,1,,,0,,,,,,
20200322,VA,3337,547,219,67,3118,480,3,1,32,,7,,,,,,
20200322,VI,6,0,6,0,,0,,0,,,0,,,,,,
20200322,VT,1280,148,76,24,1204,124,2,0,,,0,,,,,,
20200322,WA,47010,1888,5121,284,41889,1604,126,15,,,0,,,,,,
20200322,WI,6655,1712,425,110,6230,1602,4,0,,,0,,,,,,
20200322,WV,397,56,12,1,385,55,0,0,1,,0,,,,,,
20200322,WY,462,1,24,1,438,0,,0,,,0,,,,,,
20200321,AK,772,74,14,2,758,72,0,0,0,,0,,,,,,
20200321,AL,152,43,124,43,28,0,0,0,,,0,,,,,,
20200321,AR,685,238,118,22,567,216,,0,,,0,,,,,,
20200321,AS,0,0,,0,,0,0,0,,,0,,,,,,
20200321,AZ,344,68,104,39,240,29,1,1,128,,20,,,,,,
20200321,CA,12528,1041,1279,216,11249,825,24,4,,,0,,,,,,
20200321,CO,3680,728,363,86,3317,642,4,1,44,,44,,,,,,
20200321,CT,2300,1502,194,0,2106,1502,4,1,,,0,,,,,,
20200321,DC,583,11,77,6,506,5,1,0,,,0,,,,,,
20200321,DE,81,7,45,7,36,0,0,0,,,0,,,,,,
20200321,FL,7237,4847,658,138,6579,4709,12,2,158,,158,,,,,,
20200321,GA,3064,678,507,87,2557,591,14,1,,,0,,,,,,
20200321,GU,123,23,15,1,108,22,,0,,,0,,,,,,
20200321,HI,161,11,37,11,124,0,,0,,,0,,,,,,
20200321,IA,1117,430,68,23,1049,407,,0,,,0,,,,,,
20200321,ID,911,298,31,8,880,290,,0,,,0,,,,,,
20200321,IL,6241,1960,753,168,5488,1792,6,1,,,0,,,,,,
20200321,IN,833,279,126,47,707,232,4,2,1,,1,,,,,,
20200321,KS,472,11,55,11,417,0,2,1,,,0,,,,,,
20200321,KY,768,129,54,7,714,122,2,1,,,0,,,,,,
20200321,LA,2760,1719,580,107,2180,1612,16,4,,,0,,,,,,
20200321,MA,5225,1116,426,112,4799,1004,7,2,61,,61,,,,,,
20200321,MD,284,41,190,41,94,0,3,0,,,0,,,,,,
20200321,ME,2337,16,73,16,2264,0,,0,,,0,,,,,,
20200321,MI,11109,1849,7023,804,4086,1045,23,10,,,0,,,,,,
20200321,MN,4279,235,327,24,3952,211,1,1,,,0,,,,,,
20200321,MO,442,26,73,26,369,0,3,2,,,0,,,,,,
20200321,MP,0,0,0,0,,0,0,0,,,0,,,,,,
20200321,MS,835,60,140,60,695,0,1,0,,,0,,,,,,
20200321,MT,1166,219,20,4,1146,215,,0,,,0,,,,,,
20200321,NC,5276,2043,184,47,5092,1996,0,0,,,0,,,,,,
20200321,ND,1169,349,28,8,1141,341,0,0,3,,3,,,,,,
20200321,NE,394,122,38,6,356,116,0,0,,,0,,,,,,
20200321,NH,1028,239,55,11,973,228,,0,,,0,,,,,,
20200321,NJ,1621,467,1327,437,294,30,16,5,,,0,,,,,,
20200321,NM,3828,14,57,14,3771,0,,0,,,0,,,,,,
20200321,NV,2508,407,124,15,2384,392,5,2,,,0,,,,,,
20200321,NY,45437,13010,10356,3254,35081,9756,44,9,1531,1436,1531,,,,,,
20200321,OH,387,78,247,78,140,0,3,2,58,,58,,,,,,
20200321,OK,613,26,53,4,560,22,1,0,10,,10,,,,,,
20200321,OR,2117,0,114,0,2003,0,3,0,,,0,,,,,,
20200321,PA,4137,1295,371,103,3766,1192,2,1,,,0,,,,,,
20200321,PR,164,36,21,7,143,29,,0,,,0,,,,,,
20200321,RI,1372,137,88,14,1284,123,,0,,,0,,,,,,
20200321,SC,1407,493,152,71,1255,422,1,0,,,0,,,,,,
20200321,SD,705,28,14,0,691,28,1,0,,,0,,,,,,
20200321,TN,3643,2852,371,143,3272,2709,,0,,,0,,,,,,
20200321,TX,6522,1245,304,110,6218,1135,5,0,,,0,,,,,,
20200321,UT,2560,413,136,24,2424,389,0,0,,,0,,,,,,
20200321,VA,2790,465,152,38,2638,427,2,0,25,,25,,,,,,
20200321,VI,6,3,6,3,,0,,0,,,0,,,,,,
20200321,VT,1132,131,52,8,1080,123,2,0,,,0,,,,,,
20200321,WA,45122,2342,4837,286,40285,2056,111,7,,,0,,,,,,
20200321,WI,4943,1253,315,80,4628,1173,4,1,,,0,,,,,,
20200321,WV,341,115,11,4,330,111,0,0,1,,1,,,,,,
20200321,WY,461,111,23,4,438,107,,0,,,0,,,,,,
20200320,AK,698,260,12,6,686,254,0,0,,,0,,,,,,
20200320,AL,109,13,81,13,28,0,0,0,,,0,,,,,,
20200320,AR,447,91,96,50,351,41,,0,,,0,,,,,,
20200320,AS,0,0,,0,,0,0,0,,,0,,,,,,
20200320,AZ,276,57,65,21,211,36,0,0,108,,23,,,,,,
20200320,CA,11487,1776,1063,139,10424,1637,20,2,,,0,,,,,,
20200320,CO,2952,624,277,61,2675,563,3,1,,,0,,,,,,
20200320,CT,798,98,194,98,604,0,3,2,,,0,,,,,,
20200320,DC,572,380,71,32,501,348,1,1,,,0,,,,,,
20200320,DE,74,8,38,8,36,0,0,0,,,0,,,,,,
20200320,FL,2390,467,520,130,1870,337,10,2,,,0,,,,,,
20200320,GA,2386,555,420,133,1966,422,13,3,,,0,,,,,,
20200320,GU,100,19,14,2,86,17,,0,,,0,,,,,,
20200320,HI,150,41,26,10,124,31,,0,,,0,,,,,,
20200320,IA,687,566,45,7,642,559,,0,,,0,,,,,,
20200320,ID,613,143,23,12,590,131,,0,,,0,,,,,,
20200320,IL,4281,1134,585,163,3696,971,5,1,,,0,,,,,,
20200320,IN,554,174,79,23,475,151,2,0,,,0,,,,,,
20200320,KS,461,10,44,10,417,0,1,0,,,0,,,,,,
20200320,KY,639,150,47,12,592,138,1,0,,,0,,,,,,
20200320,LA,1041,236,473,126,568,110,12,4,,,0,,,,,,
20200320,MA,4109,962,314,85,3795,877,5,2,,,0,,,,,,
20200320,MD,243,42,149,42,94,0,3,1,,,0,,,,,,
20200320,ME,2321,264,57,4,2264,260,,0,,,0,,,,,,
20200320,MI,9260,1933,6219,943,3041,990,13,3,,,0,,,,,,
20200320,MN,4044,808,303,16,3741,792,,0,,,0,,,,,,
20200320,MO,416,84,47,23,369,61,1,0,,,0,,,,,,
20200320,MP,0,0,0,0,,0,0,0,,,0,,,,,,
20200320,MS,775,173,80,30,695,143,1,1,,,0,,,,,,
20200320,MT,947,174,16,4,931,170,,0,,,0,,,,,,
20200320,NC,3233,728,137,40,3096,688,0,0,,,0,,,,,,
20200320,ND,820,312,20,5,800,307,0,0,,,0,,,,,,
20200320,NE,272,5,32,5,240,0,0,0,,,0,,,,,,
20200320,NH,789,129,44,5,745,124,,0,,,0,,,,,,
20200320,NJ,1154,202,890,148,264,54,11,2,,,0,,,,,,
20200320,NM,3814,1017,43,8,3771,1009,,0,,,0,,,,,,
20200320,NV,2101,380,109,14,1992,366,3,0,,,0,,,,,,
20200320,NY,32427,10143,7102,2950,25325,7193,35,23,,1042,0,,,,,,
20200320,OH,309,50,169,50,140,0,1,1,,,0,,,,,,
20200320,OK,587,77,49,5,538,72,1,0,,,0,,,,,,
20200320,OR,2117,700,114,26,2003,674,3,0,,,0,,,,,,
20200320,PA,2842,1049,268,83,2574,966,1,0,,,0,,,,,,
20200320,PR,128,67,14,9,114,58,,0,,,0,,,,,,
20200320,RI,1235,206,74,13,1161,193,,0,,,0,,,,,,
20200320,SC,914,271,81,21,833,250,1,0,,,0,,,,,,
20200320,SD,677,115,14,3,663,112,1,0,,,0,,,,,,
20200320,TN,791,288,228,74,563,214,,0,,,0,,,,,,
20200320,TX,5277,2922,194,51,5083,2871,5,2,,,0,,,,,,
20200320,UT,2147,621,112,34,2035,587,0,0,,,0,,,,,,
20200320,VA,2325,402,114,20,2211,382,2,0,,,0,,,,,,
20200320,VI,3,0,3,0,,0,,0,,,0,,,,,,
20200320,VT,1001,209,44,16,957,193,2,2,,,0,,,,,,
20200320,WA,42780,4061,4551,405,38229,3656,104,12,,,0,,,,,,
20200320,WI,3690,1324,235,61,3455,1263,3,3,,,0,,,,,,
20200320,WV,226,81,7,5,219,76,0,0,,,0,,,,,,
20200320,WY,350,61,19,1,331,60,,0,,,0,,,,,,
20200319,AK,438,26,6,0,432,26,0,0,,,0,,,,,,
20200319,AL,96,22,68,22,28,0,0,0,,,0,,,,,,
20200319,AR,356,87,46,13,310,74,,0,,,0,,,,,,
20200319,AS,0,0,,0,,0,0,0,,,0,,,,,,
20200319,AZ,219,43,44,16,175,27,0,0,85,,18,,,,,,
20200319,CA,9711,1119,924,313,8787,806,18,5,,,0,,,,,,
20200319,CO,2328,528,216,33,2112,495,2,0,,,0,,,,,,
20200319,CT,700,507,96,28,604,479,1,1,,,0,,,,,,
20200319,DC,192,23,39,8,153,15,0,0,,,0,,,,,,
20200319,DE,66,5,30,5,36,0,0,0,,,0,,,,,,
20200319,FL,1923,384,390,76,1533,308,8,1,,,0,,,,,,
20200319,GA,1831,323,287,90,1544,233,10,9,,,0,,,,,,
20200319,GU,81,16,12,4,69,12,,0,,,0,,,,,,
20200319,HI,109,2,16,2,93,0,,0,,,0,,,,,,
20200319,IA,121,9,38,9,83,0,,0,,,0,,,,,,
20200319,ID,470,2,11,2,459,0,,0,,,0,,,,,,
20200319,IL,3147,1096,422,134,2725,962,4,3,,,0,,,,,,
20200319,IN,380,187,56,17,324,170,2,0,,,0,,,,,,
20200319,KS,451,18,34,18,417,0,1,0,,,0,,,,,,
20200319,KY,489,109,35,9,454,100,1,0,,,0,,,,,,
20200319,LA,805,230,347,107,458,123,8,2,,,0,,,,,,
20200319,MA,3147,876,229,73,2918,803,3,1,,,0,,,,,,
20200319,MD,201,22,107,22,94,0,2,0,,,0,,,,,,
20200319,ME,2057,344,53,10,2004,334,,0,,,0,,,,,,
20200319,MI,7327,1318,5276,745,2051,573,10,5,,,0,,,,,,
20200319,MN,3236,282,287,18,2949,264,,0,,,0,,,,,,
20200319,MO,332,66,24,11,308,55,1,1,,,0,,,,,,
20200319,MP,0,0,0,0,,0,0,0,,,0,,,,,,
20200319,MS,602,89,50,16,552,73,,0,,,0,,,,,,
20200319,MT,773,264,12,2,761,262,,0,,,0,,,,,,
20200319,NC,2505,655,97,34,2408,621,0,0,,,0,,,,,,
20200319,ND,508,234,15,9,493,225,0,0,,,0,,,,,,
20200319,NE,267,37,27,3,240,34,0,0,,,0,,,,,,
20200319,NH,660,121,39,13,621,108,,0,,,0,,,,,,
20200319,NJ,952,335,742,315,210,20,9,4,,,0,,,,,,
20200319,NM,2797,443,35,7,2762,436,,0,,,0,,,,,,
20200319,NV,1721,1498,95,40,1626,1458,3,1,,,0,,,,,,
20200319,NY,22284,7687,4152,1770,18132,5917,12,0,,617,0,,,,,,
20200319,OH,259,31,119,31,140,0,,0,,,0,,,,,,
20200319,OK,510,103,44,15,466,88,1,1,,,0,,,,,,
20200319,OR,1417,224,88,13,1329,211,3,0,,,0,,,,,,
20200319,PA,1793,473,185,52,1608,421,1,0,,,0,,,,,,
20200319,PR,61,25,5,0,56,25,,0,,,0,,,,,,
20200319,RI,1029,266,61,17,968,249,,0,,,0,,,,,,
20200319,SC,643,0,60,0,583,0,1,0,,,0,,,,,,
20200319,SD,562,0,11,0,551,0,1,0,,,0,,,,,,
20200319,TN,503,56,154,56,349,0,,0,,,0,,,,,,
20200319,TX,2355,448,143,60,2212,388,3,1,,,0,,,,,,
20200319,UT,1526,1332,78,15,1448,1317,0,0,,,0,,,,,,
20200319,VA,1923,645,94,17,1829,628,2,1,,,0,,,,,,
20200319,VI,3,1,3,1,,0,,0,,,0,,,,,,
20200319,VT,792,134,28,7,764,127,,0,,,0,,,,,,
20200319,WA,38719,4550,4146,336,34573,4214,92,10,,,0,,,,,,
20200319,WI,2366,668,174,53,2192,615,,0,,,0,,,,,,
20200319,WV,145,22,2,1,143,21,0,0,,,0,,,,,,
20200319,WY,289,96,18,3,271,93,,0,,,0,,,,,,
20200318,AK,412,75,6,3,406,72,0,0,,,0,,,,,,
20200318,AL,74,10,46,10,28,0,0,0,,,0,,,,,,
20200318,AR,269,50,33,11,236,39,,0,,,0,,,,,,
20200318,AS,0,0,,0,,0,0,0,,,0,,,,,,
20200318,AZ,176,14,28,8,148,6,0,0,67,,12,,,,,,
20200318,CA,8592,128,611,128,7981,0,13,2,,,0,,,,,,
20200318,CO,1800,584,183,23,1617,561,2,1,,,0,,,,,,
20200318,CT,193,27,68,27,125,0,,0,,,0,,,,,,
20200318,DC,169,43,31,9,138,34,,0,,,0,,,,,,
20200318,DE,61,9,25,9,36,0,0,0,,,0,,,,,,
20200318,FL,1539,413,314,128,1225,285,7,1,,,0,,,,,,
20200318,GA,1508,1362,197,51,1311,1311,1,0,,,0,,,,,,
20200318,GU,65,19,8,3,57,16,,0,,,0,,,,,,
20200318,HI,107,97,14,4,93,93,,0,,,0,,,,,,
20200318,IA,112,6,29,6,83,0,,0,,,0,,,,,,
20200318,ID,468,115,9,2,459,113,,0,,,0,,,,,,
20200318,IL,2051,552,288,129,1763,423,1,0,,,0,,,,,,
20200318,IN,193,34,39,9,154,25,2,0,,,0,,,,,,
20200318,KS,433,36,16,1,417,35,1,0,,,0,,,,,,
20200318,KY,380,63,26,4,354,59,1,0,,,0,,,,,,
20200318,LA,575,152,240,103,335,49,6,2,,,0,,,,,,
20200318,MA,2271,520,156,38,2115,482,2,2,,,0,,,,,,
20200318,MD,179,28,85,28,94,0,2,2,,,0,,,,,,
20200318,ME,1713,378,43,11,1670,367,,0,,,0,,,,,,
20200318,MI,6009,1471,4531,872,1478,599,5,3,,,0,,,,,,
20200318,MN,2954,432,269,23,2685,409,,0,,,0,,,,,,
20200318,MO,266,51,13,5,253,46,0,0,,,0,,,,,,
20200318,MP,0,0,0,0,,0,0,0,,,0,,,,,,
20200318,MS,513,124,34,13,479,111,,0,,,0,,,,,,
20200318,MT,509,198,10,2,499,196,,0,,,0,,,,,,
20200318,NC,1850,1336,63,23,1787,1313,0,0,,,0,,,,,,
20200318,ND,274,51,6,3,268,48,0,0,,,0,,,,,,
20200318,NE,230,3,24,3,206,0,,0,,,0,,,,,,
20200318,NH,539,167,26,9,513,158,,0,,,0,,,,,,
20200318,NJ,617,187,427,160,190,27,5,2,,,0,,,,,,
20200318,NM,2354,1082,28,5,2326,1077,,0,,,0,,,,,,
20200318,NV,223,0,55,0,168,0,2,1,,,0,,,,,,
20200318,NY,14597,7391,2382,682,12215,6709,12,5,,416,0,,,,,,
20200318,OH,228,21,88,21,140,0,,0,,,0,,,,,,
20200318,OK,407,143,29,12,378,131,,0,,,0,,,,,,
20200318,OR,1193,457,75,28,1118,429,3,3,,,0,,,,,,
20200318,PA,1320,345,133,37,1187,308,1,1,,,0,,,,,,
20200318,PR,36,18,5,0,31,18,,0,,,0,,,,,,
20200318,RI,763,122,44,11,719,111,,0,,,0,,,,,,
20200318,SC,643,299,60,27,583,272,1,0,,,0,,,,,,
20200318,SD,562,0,11,0,551,0,1,1,,,0,,,,,,
20200318,TN,447,44,98,25,349,19,,0,,,0,,,,,,
20200318,TX,1907,639,83,19,1824,620,2,1,,,0,,,,,,
20200318,UT,194,12,63,12,131,0,0,0,,,0,,,,,,
20200318,VA,1278,250,77,10,1201,240,1,0,,,0,,,,,,
20200318,VI,2,0,2,0,,0,,0,,,0,,,,,,
20200318,VT,658,58,21,2,637,56,,0,,,0,,,,,,
20200318,WA,34169,4740,3810,378,30359,4362,82,4,,,0,,,,,,
20200318,WI,1698,577,121,38,1577,539,,0,,,0,,,,,,
20200318,WV,123,43,1,1,122,42,0,0,,,0,,,,,,
20200318,WY,193,88,15,5,178,83,,0,,,0,,,,,,
20200317,AK,337,193,3,2,334,191,0,0,,,0,,,,,,
20200317,AL,64,8,36,8,28,0,0,0,,,0,,,,,,
20200317,AR,219,65,22,0,197,65,,0,,,0,,,,,,
20200317,AS,0,0,,0,,0,,0,,,0,,,,,,
20200317,AZ,162,19,20,2,142,17,0,0,55,,13,,,,,,
20200317,CA,8464,148,483,148,7981,0,11,5,,,0,,,,,,
20200317,CO,1216,458,160,29,1056,429,1,0,,,0,,,,,,
20200317,CT,166,15,41,15,125,0,,0,,,0,,,,,,
20200317,DC,126,13,22,5,104,8,,0,,,0,,,,,,
20200317,DE,52,8,16,8,36,0,0,0,,,0,,,,,,
20200317,FL,1126,301,186,45,940,256,6,2,,,0,,,,,,
20200317,GA,146,25,146,25,,0,1,0,,,0,,,,,,
20200317,GU,46,20,5,2,41,18,,0,,,0,,,,,,
20200317,HI,10,3,10,3,,0,,0,,,0,,,,,,
20200317,IA,106,1,23,1,83,0,,0,,,0,,,,,,
20200317,ID,353,83,7,2,346,81,,0,,,0,,,,,,
20200317,IL,1499,474,159,66,1340,408,1,1,,,0,,,,,,
20200317,IN,159,20,30,6,129,14,2,1,,,0,,,,,,
20200317,KS,397,220,15,4,382,216,1,0,,,0,,,,,,
20200317,KY,317,62,22,1,295,61,1,0,,,0,,,,,,
20200317,LA,423,120,137,22,286,98,4,2,,,0,,,,,,
20200317,MA,1751,455,118,21,1633,434,,0,,,0,,,,,,
20200317,MD,151,20,57,20,94,0,,-2,,,0,,,,,,
20200317,ME,1335,554,32,15,1303,539,,0,,,0,,,,,,
20200317,MI,4538,2333,3659,1726,879,607,2,2,,,0,,,,,,
20200317,MN,2522,504,246,67,2276,437,,0,,,0,,,,,,
20200317,MO,215,45,8,2,207,43,0,0,,,0,,,,,,
20200317,MP,0,0,0,0,,0,,0,,,0,,,,,,
20200317,MS,389,100,21,9,368,91,,0,,,0,,,,,,
20200317,MT,311,106,8,1,303,105,,0,,,0,,,,,,
20200317,NC,514,185,40,7,474,178,0,0,,,0,,,,,,
20200317,ND,223,99,3,2,220,97,0,0,,,0,,,,,,
20200317,NE,227,39,21,3,206,36,,0,,,0,,,,,,
20200317,NH,372,88,17,4,355,84,,0,,,0,,,,,,
20200317,NJ,430,132,267,89,163,43,3,1,,,0,,,,,,
20200317,NM,1272,689,23,6,1249,683,,0,,,0,,,,,,
20200317,NV,223,10,55,10,168,0,1,0,,,0,,,,,,
20200317,NY,7206,1713,1700,750,5506,963,7,0,,325,0,,,,,,
20200317,OH,207,17,67,17,140,0,,0,,,0,,,,,,
20200317,OK,264,80,17,7,247,73,,0,,,0,,,,,,
20200317,OR,736,118,47,8,689,110,,0,,,0,,,,,,
20200317,PA,975,229,96,20,879,209,,0,,,0,,,,,,
20200317,PR,18,4,5,0,13,4,,0,,,0,,,,,,
20200317,RI,641,164,33,11,608,153,,0,,,0,,,,,,
20200317,SC,344,81,33,5,311,76,1,0,,,0,,,,,,
20200317,SD,562,58,11,1,551,57,,0,,,0,,,,,,
20200317,TN,403,81,73,21,330,60,,0,,,0,,,,,,
20200317,TX,1268,1211,64,7,1204,1204,1,1,,,0,,,,,,
20200317,UT,182,12,51,12,131,0,0,0,,,0,,,,,,
20200317,VA,1028,539,67,16,961,523,1,0,,,0,,,,,,
20200317,VI,2,1,2,1,,0,,0,,,0,,,,,,
20200317,VT,600,96,19,2,581,94,,0,,,0,,,,,,
20200317,WA,29429,4638,3432,325,25997,4313,78,9,,,0,,,,,,
20200317,WI,1121,561,83,27,1038,534,,0,,,0,,,,,,
20200317,WV,80,0,0,0,80,0,0,0,,,0,,,,,,
20200317,WY,105,102,10,7,95,95,,0,,,0,,,,,,
20200316,AK,144,0,1,0,143,0,0,0,,,0,,,,,,
20200316,AL,56,16,28,16,28,0,0,0,,,0,,,,,,
20200316,AR,154,35,22,6,132,29,,0,,,0,,,,,,
20200316,AS,0,0,,0,,0,,0,,,0,,,,,,
20200316,AZ,143,10,18,6,125,4,0,0,42,,6,,,,,,
20200316,CA,8316,7107,335,42,7981,7065,6,1,,,0,,,,,,
20200316,CO,758,0,131,0,627,0,1,0,,,0,,,,,,
20200316,CT,151,6,26,6,125,0,,0,,,0,,,,,,
20200316,DC,113,18,17,1,96,17,,0,,,0,,,,,,
20200316,DE,44,2,8,2,36,0,0,0,,,0,,,,,,
20200316,FL,825,31,141,25,684,6,4,0,,,0,,,,,,
20200316,GA,121,22,121,22,,0,1,0,,,0,,,,,,
20200316,GU,26,0,3,0,23,0,,0,,,0,,,,,,
20200316,HI,7,5,7,5,,0,,0,,,0,,,,,,
20200316,IA,105,4,22,4,83,0,,0,,,0,,,,,,
20200316,ID,270,91,5,0,265,91,,0,,,0,,,,,,
20200316,IL,1025,512,93,29,932,483,,0,,,0,,,,,,
20200316,IN,139,18,24,5,115,13,1,1,,,0,,,,,,
20200316,KS,177,34,11,3,166,31,1,0,,,0,,,,,,
20200316,KY,255,100,21,5,234,95,1,0,,,0,,,,,,
20200316,LA,303,57,115,25,188,32,2,0,,,0,,,,,,
20200316,MA,1296,648,97,33,1199,615,,0,,,0,,,,,,
20200316,MD,131,6,37,6,94,0,2,2,,,0,,,,,,
20200316,ME,781,687,17,14,764,673,,0,,,0,,,,,,
20200316,MI,2205,520,1933,453,272,67,,0,,,0,,,,,,
20200316,MN,2018,503,179,51,1839,452,,0,,,0,,,,,,
20200316,MO,170,43,6,1,164,42,0,0,,,0,,,,,,
20200316,MP,0,0,0,0,,0,,0,,,0,,,,,,
20200316,MS,289,195,12,2,277,193,,0,,,0,,,,,,
20200316,MT,205,95,7,0,198,95,,0,,,0,,,,,,
20200316,NC,329,70,33,1,296,69,0,0,,,0,,,,,,
20200316,ND,124,28,1,0,123,28,0,0,,,0,,,,,,
20200316,NE,188,91,18,1,170,90,,0,,,0,,,,,,
20200316,NH,284,0,13,0,271,0,,0,,,0,,,,,,
20200316,NJ,298,80,178,80,120,0,2,0,,,0,,,,,,
20200316,NM,583,88,17,4,566,84,,0,,,0,,,,,,
20200316,NV,213,24,45,24,168,0,1,0,,,0,,,,,,
20200316,NY,5493,221,950,221,4543,0,7,4,,,0,,,,,,
20200316,OH,190,15,50,14,140,1,,0,,,0,,,,,,
20200316,OK,184,57,10,1,174,56,,0,,,0,,,,,,
20200316,OR,618,162,39,3,579,159,,0,,,0,,,,,,
20200316,PA,746,478,76,13,670,465,,0,,,0,,,,,,
20200316,PR,14,0,5,0,9,0,,0,,,0,,,,,,
20200316,RI,477,93,22,2,455,91,,0,,,0,,,,,,
20200316,SC,263,90,28,9,235,81,1,1,,,0,,,,,,
20200316,SD,504,168,10,1,494,167,,0,,,0,,,,,,
20200316,TN,322,126,52,13,270,113,,0,,,0,,,,,,
20200316,TX,57,1,57,1,,0,,0,,,0,,,,,,
20200316,UT,170,11,39,11,131,0,0,0,,,0,,,,,,
20200316,VA,489,81,51,6,438,75,1,0,,,0,,,,,,
20200316,VI,1,0,1,0,,0,,0,,,0,,,,,,
20200316,VT,504,87,17,5,487,82,,0,,,0,,,,,,
20200316,WA,24791,4895,3107,369,21684,4526,69,12,,,0,,,,,,
20200316,WI,560,210,56,19,504,191,,0,,,0,,,,,,
20200316,WV,80,42,0,0,80,42,0,0,,,0,,,,,,
20200316,WY,3,0,3,0,,0,,0,,,0,,,,,,
20200315,AK,144,0,1,0,143,0,0,0,,,0,,,,,,
20200315,AL,40,12,12,6,28,6,0,0,,,0,,,,,,
20200315,AR,119,42,16,4,103,38,,0,,,0,,,,,,
20200315,AZ,133,0,12,0,121,0,0,0,36,,10,,,,,,
20200315,CA,1209,41,293,41,916,0,5,0,,,0,,,,,,
20200315,CO,758,47,131,30,627,17,1,0,,,0,,,,,,
20200315,CT,145,9,20,9,125,0,,0,,,0,,,,,,
20200315,DC,95,36,16,6,79,30,,0,,,0,,,,,,
20200315,DE,42,0,6,0,36,0,0,0,,,0,,,,,,
20200315,FL,794,239,116,39,678,200,4,1,,,0,,,,,,
20200315,GA,99,33,99,33,,0,1,0,,,0,,,,,,
20200315,HI,2,0,2,0,,0,,0,,,0,,,,,,
20200315,IA,101,1,18,1,83,0,,0,,,0,,,,,,
20200315,ID,179,3,5,3,174,0,,0,,,0,,,,,,
20200315,IL,513,151,64,18,449,133,,0,,,0,,,,,,
20200315,IN,121,32,19,4,102,28,0,0,,,0,,,,,,
20200315,KS,143,44,8,2,135,42,1,0,,,0,,,,,,
20200315,KY,155,2,16,2,139,0,1,0,,,0,,,,,,
20200315,LA,246,86,90,39,156,47,2,2,,,0,,,,,,
20200315,MA,648,610,64,26,584,584,,0,,,0,,,,,,
20200315,MD,125,5,31,5,94,0,,0,,,0,,,,,,
20200315,ME,94,0,3,0,91,0,,0,,,0,,,,,,
20200315,MI,1685,284,1480,284,205,0,,0,,,0,,,,,,
20200315,MN,1515,578,128,38,1387,540,,0,,,0,,,,,,
20200315,MO,127,33,5,1,122,32,0,0,,,0,,,,,,
20200315,MS,94,4,10,4,84,0,,0,,,0,,,,,,
20200315,MT,110,2,7,2,103,0,,0,,,0,,,,,,
20200315,NC,259,99,32,9,227,90,,0,,,0,,,,,,
20200315,ND,96,41,1,0,95,41,0,0,,,0,,,,,,
20200315,NE,97,3,17,3,80,0,,0,,,0,,,,,,
20200315,NH,284,65,13,6,271,59,,0,,,0,,,,,,
20200315,NJ,218,71,98,48,120,23,2,1,,,0,,,,,,
20200315,NM,495,248,13,3,482,245,,0,,,0,,,,,,
20200315,NV,189,1,21,1,168,0,1,1,,,0,,,,,,
20200315,NY,5272,1969,729,205,4543,1764,3,3,,,0,,,,,,
20200315,OH,175,112,36,23,139,89,,0,,,0,,,,,,
20200315,OK,127,87,9,5,118,82,,0,,,0,,,,,,
20200315,OR,456,89,36,6,420,83,,0,,,0,,,,,,
20200315,PA,268,16,63,16,205,0,,0,,,0,,,,,,
20200315,RI,384,55,20,1,364,54,,0,,,0,,,,,,
20200315,SC,173,50,19,6,154,44,,0,,,0,,,,,,
20200315,SD,336,145,9,0,327,145,,0,,,0,,,,,,
20200315,TN,196,34,39,7,157,27,,0,,,0,,,,,,
20200315,TX,56,5,56,5,,0,,0,,,0,,,,,,
20200315,UT,159,22,28,22,131,0,0,0,,,0,,,,,,
20200315,VA,408,261,45,15,363,246,1,1,,,0,,,,,,
20200315,VT,417,77,12,4,405,73,,0,,,0,,,,,,
20200315,WA,19896,1689,2738,254,17158,1435,57,6,,,0,,,,,,
20200315,WI,350,158,37,14,313,144,,0,,,0,,,,,,
20200315,WV,38,12,0,0,38,12,0,0,,,0,,,,,,
20200315,WY,3,1,3,1,,0,,0,,,0,,,,,,
20200314,AK,144,84,1,0,143,84,0,0,,,0,,,,,,
20200314,AL,28,16,6,5,22,11,,0,,,0,,,,,,
20200314,AR,77,38,12,3,65,35,,0,,,0,,,,,,
20200314,AZ,133,30,12,3,121,27,0,0,26,,4,,,,,,
20200314,CA,1168,50,252,50,916,0,5,1,,,0,,,,,,
20200314,CO,711,115,101,29,610,86,1,1,,,0,,,,,,
20200314,CT,136,31,11,5,125,26,,0,,,0,,,,,,
20200314,DC,59,29,10,0,49,29,,0,,,0,,,,,,
20200314,DE,42,8,6,2,36,6,0,0,,,0,,,,,,
20200314,FL,555,27,77,27,478,0,3,1,,,0,,,,,,
20200314,GA,66,24,66,24,,0,1,0,,,0,,,,,,
20200314,HI,2,0,2,0,,0,,0,,,0,,,,,,
20200314,IA,100,1,17,1,83,0,,0,,,0,,,,,,
20200314,ID,176,45,2,2,174,43,,0,,,0,,,,,,
20200314,IL,362,36,46,14,316,22,,0,,,0,,,,,,
20200314,IN,89,16,15,3,74,13,0,0,,,0,,,,,,
20200314,KS,99,0,6,0,93,0,1,1,,,0,,,,,,
20200314,KY,153,35,14,3,139,32,1,1,,,0,,,,,,
20200314,LA,160,87,51,15,109,72,,0,,,0,,,,,,
20200314,MA,38,15,38,15,,0,,0,,,0,,,,,,
20200314,MD,120,9,26,9,94,0,,0,,,0,,,,,,
20200314,ME,94,0,3,0,91,0,,0,,,0,,,,,,
20200314,MI,1401,323,1196,251,205,72,,0,,,0,,,,,,
20200314,MN,937,334,90,28,847,306,,0,,,0,,,,,,
20200314,MO,94,21,4,2,90,19,0,0,,,0,,,,,,
20200314,MS,90,45,6,2,84,43,,0,,,0,,,,,,
20200314,MT,108,52,5,4,103,48,,0,,,0,,,,,,
20200314,NC,160,59,23,8,137,51,,0,,,0,,,,,,
20200314,ND,55,15,1,0,54,15,0,0,,,0,,,,,,
20200314,NE,94,1,14,1,80,0,,0,,,0,,,,,,
20200314,NH,219,119,7,1,212,118,,0,,,0,,,,,,
20200314,NJ,147,0,50,0,97,0,1,0,,,0,,,,,,
20200314,NM,247,47,10,0,237,47,,0,,,0,,,,,,
20200314,NV,188,9,20,9,168,0,0,0,,,0,,,,,,
20200314,NY,3303,103,524,103,2779,0,,0,,,0,,,,,,
20200314,OH,63,0,13,0,50,0,,0,,,0,,,,,,
20200314,OK,40,1,4,1,36,0,,0,,,0,,,,,,
20200314,OR,367,0,30,0,337,0,,0,,,0,,,,,,
20200314,PA,252,71,47,6,205,65,,0,,,0,,,,,,
20200314,RI,329,86,19,0,310,86,,0,,,0,,,,,,
20200314,SC,123,36,13,1,110,35,,0,,,0,,,,,,
20200314,SD,191,109,9,0,182,109,,0,,,0,,,,,,
20200314,TN,162,20,32,6,130,14,,0,,,0,,,,,,
20200314,TX,51,12,51,12,,0,,0,,,0,,,,,,
20200314,UT,137,0,6,0,131,0,,0,,,0,,,,,,
20200314,VA,147,0,30,0,117,0,,0,,,0,,,,,,
20200314,VT,340,112,8,3,332,109,,0,,,0,,,,,,
20200314,WA,18207,2329,2484,266,15723,2063,51,4,,,0,,,,,,
20200314,WI,192,0,23,0,169,0,,0,,,0,,,,,,
20200314,WV,26,9,0,0,26,9,,0,,,0,,,,,,
20200314,WY,2,1,2,1,,0,,0,,,0,,,,,,
20200313,AK,60,14,1,1,59,13,0,0,,,0,,,,,,
20200313,AL,12,2,1,1,11,1,,0,,,0,,,,,,
20200313,AR,39,9,9,3,30,6,,0,,,0,,,,,,
20200313,AZ,103,12,9,0,94,12,0,0,22,,6,,,,,,
20200313,CA,1118,0,202,0,916,0,4,0,,,0,,,,,,
20200313,CO,596,253,72,27,524,226,,0,,,0,,,,,,
20200313,CT,105,10,6,0,99,10,,0,,,0,,,,,,
20200313,DC,30,0,10,0,20,0,,0,,,0,,,,,,
20200313,DE,34,7,4,0,30,7,0,0,,,0,,,,,,
20200313,FL,528,195,50,18,478,177,2,0,,,0,,,,,,
20200313,GA,42,11,42,11,,0,1,1,,,0,,,,,,
20200313,HI,2,0,2,0,,0,,0,,,0,,,,,,
20200313,IA,99,18,16,2,83,16,,0,,,0,,,,,,
20200313,ID,131,38,0,0,131,38,,0,,,0,,,,,,
20200313,IL,326,35,32,7,294,28,,0,,,0,,,,,,
20200313,IN,73,9,12,0,61,9,,0,,,0,,,,,,
20200313,KS,99,54,6,2,93,52,,0,,,0,,,,,,
20200313,KY,118,54,11,3,107,51,,0,,,0,,,,,,
20200313,LA,73,22,36,22,37,0,,0,,,0,,,,,,
20200313,MA,23,15,23,15,,0,,0,,,0,,,,,,
20200313,MD,111,5,17,5,94,0,,0,,,0,,,,,,
20200313,ME,94,28,3,2,91,26,,0,,,0,,,,,,
20200313,MI,1078,285,945,243,133,42,,0,,,0,,,,,,
20200313,MN,603,253,62,19,541,234,,0,,,0,,,,,,
20200313,MO,73,8,2,1,71,7,,0,,,0,,,,,,
20200313,MS,45,3,4,3,41,0,,0,,,0,,,,,,
20200313,MT,56,21,1,0,55,21,,0,,,0,,,,,,
20200313,NC,101,29,15,3,86,26,,0,,,0,,,,,,
20200313,ND,40,27,1,0,39,27,0,0,,,0,,,,,,
20200313,NE,93,3,13,3,80,0,,0,,,0,,,,,,
20200313,NH,100,0,6,0,94,0,,0,,,0,,,,,,
20200313,NJ,147,43,50,20,97,23,1,0,,,0,,,,,,
20200313,NM,200,40,10,5,190,35,,0,,,0,,,,,,
20200313,NV,179,4,11,4,168,0,0,0,,,0,,,,,,
20200313,NY,3200,2892,421,205,2779,2687,,0,,,0,,,,,,
20200313,OH,63,28,13,8,50,20,,0,,,0,,,,,,
20200313,OK,39,0,3,0,36,0,,0,,,0,,,,,,
20200313,OR,367,62,30,11,337,51,,0,,,0,,,,,,
20200313,PA,181,43,41,19,140,24,,0,,,0,,,,,,
20200313,RI,243,54,19,6,224,48,,0,,,0,,,,,,
20200313,SC,87,29,12,2,75,27,,0,,,0,,,,,,
20200313,SD,82,47,9,1,73,46,,0,,,0,,,,,,
20200313,TN,142,45,26,8,116,37,,0,,,0,,,,,,
20200313,TX,39,16,39,16,,0,,0,,,0,,,,,,
20200313,UT,137,2,6,2,131,0,,0,,,0,,,,,,
20200313,VA,147,13,30,13,117,0,,0,,,0,,,,,,
20200313,VT,228,90,5,3,223,87,,0,,,0,,,,,,
20200313,WA,15878,4234,2218,297,13660,3937,47,3,,,0,,,,,,
20200313,WI,192,99,23,14,169,85,,0,,,0,,,,,,
20200313,WV,17,10,0,0,17,10,,0,,,0,,,,,,
20200313,WY,1,0,1,0,,0,,0,,,0,,,,,,
20200312,AK,46,0,0,0,46,0,0,0,,,0,,,,,,
20200312,AL,10,0,0,0,10,0,,0,,,0,,,,,,
20200312,AR,30,18,6,6,24,12,,0,,,0,,,,,,
20200312,AZ,91,23,9,0,82,23,,0,16,,5,,,,,,
20200312,CA,1118,45,202,45,916,0,4,4,,,0,,,,,,
20200312,CO,343,64,45,17,298,47,,0,,,0,,,,,,
20200312,CT,95,21,6,3,89,18,,0,,,0,,,,,,
20200312,DC,30,5,10,5,20,0,,0,,,0,,,,,,
20200312,DE,27,9,4,3,23,6,0,0,,,0,,,,,,
20200312,FL,333,4,32,4,301,0,2,0,,,0,,,,,,
20200312,GA,31,9,31,9,,0,,0,,,0,,,,,,
20200312,HI,2,0,2,0,,0,,0,,,0,,,,,,
20200312,IA,81,22,14,1,67,21,,0,,,0,,,,,,
20200312,ID,93,26,0,0,93,26,,0,,,0,,,,,,
20200312,IL,291,28,25,6,266,22,,0,,,0,,,,,,
20200312,IN,64,21,12,2,52,19,,0,,,0,,,,,,
20200312,KS,45,3,4,3,41,0,,0,,,0,,,,,,
20200312,KY,64,10,8,0,56,10,,0,,,0,,,,,,
20200312,LA,51,8,14,8,37,0,,0,,,0,,,,,,
20200312,MA,8,0,8,0,,0,,0,,,0,,,,,,
20200312,MD,106,3,12,3,94,0,,0,,,0,,,,,,
20200312,ME,66,24,1,1,65,23,,0,,,0,,,,,,
20200312,MI,793,239,702,205,91,34,,0,,,0,,,,,,
20200312,MN,350,112,43,22,307,90,,0,,,0,,,,,,
20200312,MO,65,64,1,0,64,64,,0,,,0,,,,,,
20200312,MS,42,22,1,1,41,21,,0,,,0,,,,,,
20200312,MT,35,14,1,1,34,13,,0,,,0,,,,,,
20200312,NC,72,65,12,5,60,60,,0,,,0,,,,,,
20200312,ND,13,6,1,1,12,5,,0,,,0,,,,,,
20200312,NE,90,38,10,5,80,33,,0,,,0,,,,,,
20200312,NH,100,58,6,2,94,56,,0,,,0,,,,,,
20200312,NJ,104,23,30,6,74,17,1,0,,,0,,,,,,
20200312,NM,160,70,5,2,155,68,,0,,,0,,,,,,
20200312,NV,175,2,7,2,168,0,0,0,,,0,,,,,,
20200312,NY,308,0,216,0,92,0,,0,,,0,,,,,,
20200312,OH,35,10,5,1,30,9,,0,,,0,,,,,,
20200312,OK,39,22,3,1,36,21,,0,,,0,,,,,,
20200312,OR,305,0,19,0,286,0,,0,,,0,,,,,,
20200312,PA,138,34,22,6,116,28,,0,,,0,,,,,,
20200312,RI,189,45,13,8,176,37,,0,,,0,,,,,,
20200312,SC,58,17,10,1,48,16,,0,,,0,,,,,,
20200312,SD,35,17,8,3,27,14,,0,,,0,,,,,,
20200312,TN,97,40,18,11,79,29,,0,,,0,,,,,,
20200312,TX,23,2,23,2,,0,,0,,,0,,,,,,
20200312,UT,135,133,4,2,131,131,,0,,,0,,,,,,
20200312,VA,134,65,17,8,117,57,,0,,,0,,,,,,
20200312,VT,138,45,2,0,136,45,,0,,,0,,,,,,
20200312,WA,11644,3764,1921,256,9723,3508,44,4,,,0,,,,,,
20200312,WI,93,47,9,6,84,41,,0,,,0,,,,,,
20200312,WV,7,4,0,0,7,4,,0,,,0,,,,,,
20200312,WY,1,1,1,1,,0,,0,,,0,,,,,,
20200311,AK,46,23,0,0,46,23,0,0,,,0,,,,,,
20200311,AL,10,10,0,0,10,10,,0,,,0,,,,,,
20200311,AR,12,0,0,0,12,0,,0,,,0,,,,,,
20200311,AZ,68,11,9,3,59,8,,0,11,,3,,,,,,
20200311,CA,1073,250,157,24,916,226,,0,,,0,,,,,,
20200311,CO,279,125,28,16,251,109,,0,,,0,,,,,,
20200311,CT,74,18,3,1,71,17,,0,,,0,,,,,,
20200311,DC,25,3,5,0,20,3,,0,,,0,,,,,,
20200311,DE,18,1,1,1,17,0,0,0,,,0,,,,,,
20200311,FL,329,88,28,9,301,79,2,2,,,0,,,,,,
20200311,GA,22,5,22,5,,0,,0,,,0,,,,,,
20200311,HI,2,0,2,0,,0,,0,,,0,,,,,,
20200311,IA,59,19,13,5,46,14,,0,,,0,,,,,,
20200311,ID,67,26,0,0,67,26,,0,,,0,,,,,,
20200311,IL,263,0,19,0,244,0,,0,,,0,,,,,,
20200311,IN,43,7,10,4,33,3,,0,,,0,,,,,,
20200311,KS,42,24,1,0,41,24,,0,,,0,,,,,,
20200311,KY,54,20,8,2,46,18,,0,,,0,,,,,,
20200311,LA,43,31,6,5,37,26,,0,,,0,,,,,,
20200311,MD,103,8,9,3,94,5,,0,,,0,,,,,,
20200311,ME,42,22,0,0,42,22,,0,,,0,,,,,,
20200311,MI,554,157,497,139,57,18,,0,,,0,,,,,,
20200311,MN,238,95,21,10,217,85,,0,,,0,,,,,,
20200311,MO,1,0,1,0,,0,,0,,,0,,,,,,
20200311,MS,20,20,0,0,20,20,,0,,,0,,,,,,
20200311,MT,21,6,0,0,21,6,,0,,,0,,,,,,
20200311,NC,7,0,7,0,,0,,0,,,0,,,,,,
20200311,ND,7,1,0,0,7,1,,0,,,0,,,,,,
20200311,NE,52,2,5,2,47,0,,0,,,0,,,,,,
20200311,NH,42,0,4,0,38,0,,0,,,0,,,,,,
20200311,NJ,81,22,24,9,57,13,1,1,,,0,,,,,,
20200311,NM,90,21,3,3,87,18,,0,,,0,,,,,,
20200311,NV,173,158,5,4,168,154,0,0,,,0,,,,,,
20200311,NY,308,43,216,43,92,0,,0,,,0,,,,,,
20200311,OH,25,8,4,1,21,7,,0,,,0,,,,,,
20200311,OK,17,0,2,0,15,0,,0,,,0,,,,,,
20200311,OR,305,77,19,4,286,73,,0,,,0,,,,,,
20200311,PA,104,92,16,4,88,88,,0,,,0,,,,,,
20200311,RI,144,34,5,0,139,34,,0,,,0,,,,,,
20200311,SC,41,10,9,2,32,8,,0,,,0,,,,,,
20200311,SD,18,7,5,5,13,2,,0,,,0,,,,,,
20200311,TN,57,50,7,0,50,50,,0,,,0,,,,,,
20200311,TX,21,8,21,8,,0,,0,,,0,,,,,,
20200311,UT,2,0,2,0,,0,,0,,,0,,,,,,
20200311,VA,69,8,9,1,60,7,,0,,,0,,,,,,
20200311,VT,93,32,2,1,91,31,,0,,,0,,,,,,
20200311,WA,7880,2267,1665,212,6215,2055,40,3,,,0,,,,,,
20200311,WI,46,8,3,1,43,7,,0,,,0,,,,,,
20200311,WV,3,1,0,0,3,1,,0,,,0,,,,,,
20200311,WY,0,0,0,0,,0,,0,,,0,,,,,,
20200310,AK,23,0,0,0,23,0,0,0,,,0,,,,,,
20200310,AL,0,0,0,0,0,0,,0,,,0,,,,,,
20200310,AR,12,0,0,0,12,0,,0,,,0,,,,,,
20200310,AZ,57,8,6,1,51,7,,0,8,,0,,,,,,
20200310,CA,823,19,133,19,690,0,,0,,,0,,,,,,
20200310,CO,154,12,12,3,142,9,,0,,,0,,,,,,
20200310,CT,56,9,2,1,54,8,,0,,,0,,,,,,
20200310,DC,22,7,5,4,17,3,,0,,,0,,,,,,
20200310,DE,17,2,0,0,17,2,0,0,,,0,,,,,,
20200310,FL,241,83,19,1,222,82,,0,,,0,,,,,,
20200310,GA,17,5,17,5,,0,,0,,,0,,,,,,
20200310,HI,2,0,2,0,,0,,0,,,0,,,,,,
20200310,IA,40,11,8,5,32,6,,0,,,0,,,,,,
20200310,ID,41,0,0,0,41,0,,0,,,0,,,,,,
20200310,IL,263,65,19,12,244,53,,0,,,0,,,,,,
20200310,IN,36,34,6,4,30,30,,0,,,0,,,,,,
20200310,KS,18,6,1,0,17,6,,0,,,0,,,,,,
20200310,KY,34,13,6,2,28,11,,0,,,0,,,,,,
20200310,LA,12,6,1,0,11,6,,0,,,0,,,,,,
20200310,MD,95,17,6,1,89,16,,0,,,0,,,,,,
20200310,ME,20,19,0,0,20,19,,0,,,0,,,,,,
20200310,MI,397,107,358,104,39,3,,0,,,0,,,,,,
20200310,MN,143,58,11,6,132,52,,0,,,0,,,,,,
20200310,MO,1,0,1,0,,0,,0,,,0,,,,,,
20200310,MS,0,0,0,0,,0,,0,,,0,,,,,,
20200310,MT,15,4,0,0,15,4,,0,,,0,,,,,,
20200310,NC,7,5,7,5,,0,,0,,,0,,,,,,
20200310,ND,6,6,0,0,6,6,,0,,,0,,,,,,
20200310,NE,50,11,3,0,47,11,,0,,,0,,,,,,
20200310,NH,42,0,4,0,38,0,,0,,,0,,,,,,
20200310,NJ,59,13,15,4,44,9,,0,,,0,,,,,,
20200310,NM,69,12,0,0,69,12,,0,,,0,,,,,,
20200310,NV,15,0,1,0,14,0,0,0,,,0,,,,,,
20200310,NY,265,31,173,31,92,0,,0,,,0,,,,,,
20200310,OH,17,3,3,0,14,3,,0,,,0,,,,,,
20200310,OK,17,8,2,1,15,7,,0,,,0,,,,,,
20200310,OR,228,49,15,1,213,48,,0,,,0,,,,,,
20200310,PA,12,2,12,2,,0,,0,,,0,,,,,,
20200310,RI,110,24,5,1,105,23,,0,,,0,,,,,,
20200310,SC,31,0,7,0,24,0,,0,,,0,,,,,,
20200310,SD,11,6,0,0,11,6,,0,,,0,,,,,,
20200310,TN,7,4,7,4,,0,,0,,,0,,,,,,
20200310,TX,13,1,13,1,,0,,0,,,0,,,,,,
20200310,UT,2,1,2,1,,0,,0,,,0,,,,,,
20200310,VA,61,20,8,5,53,15,,0,,,0,,,,,,
20200310,VT,61,24,1,0,60,24,,0,,,0,,,,,,
20200310,WA,5613,1784,1453,216,4160,1568,37,2,,,0,,,,,,
20200310,WI,38,1,2,1,36,0,,0,,,0,,,,,,
20200310,WV,2,0,0,0,2,0,,0,,,0,,,,,,
20200310,WY,0,0,0,0,0,0,,0,,,0,,,,,,
20200309,AK,23,9,0,0,23,9,0,0,,,0,,,,,,
20200309,AL,0,0,0,0,,0,,0,,,0,,,,,,
20200309,AR,12,6,0,0,12,6,,0,,,0,,,,,,
20200309,AZ,49,0,5,0,44,0,,0,8,,2,,,,,,
20200309,CA,804,254,114,26,690,228,,0,,,0,,,,,,
20200309,CO,142,30,9,1,133,29,,0,,,0,,,,,,
20200309,CT,47,17,1,0,46,17,,0,,,0,,,,,,
20200309,DC,15,4,1,0,14,4,,0,,,0,,,,,,
20200309,DE,15,5,0,0,15,5,0,0,,,0,,,,,,
20200309,FL,158,23,18,1,140,22,,0,,,0,,,,,,
20200309,GA,12,5,12,5,,0,,0,,,0,,,,,,
20200309,HI,2,1,2,1,,0,,0,,,0,,,,,,
20200309,IA,29,14,3,3,26,11,,0,,,0,,,,,,
20200309,ID,41,14,0,0,41,14,,0,,,0,,,,,,
20200309,IL,198,1,7,1,191,0,,0,,,0,,,,,,
20200309,IN,2,0,2,0,,0,,0,,,0,,,,,,
20200309,KS,12,0,1,0,11,0,,0,,,0,,,,,,
20200309,KY,21,7,4,3,17,4,,0,,,0,,,,,,
20200309,LA,6,1,1,1,5,0,,0,,,0,,,,,,
20200309,MD,78,23,5,2,73,21,,0,,,0,,,,,,
20200309,ME,1,0,0,0,1,0,,0,,,0,,,,,,
20200309,MI,290,96,254,86,36,10,,0,,,0,,,,,,
20200309,MN,85,35,5,3,80,32,,0,,,0,,,,,,
20200309,MO,1,0,1,0,,0,,0,,,0,,,,,,
20200309,MS,0,0,0,0,,0,,0,,,0,,,,,,
20200309,MT,11,0,0,0,11,0,,0,,,0,,,,,,
20200309,NC,2,0,2,0,,0,,0,,,0,,,,,,
20200309,ND,0,0,0,0,0,0,,0,,,0,,,,,,
20200309,NE,39,21,3,2,36,19,,0,,,0,,,,,,
20200309,NH,42,0,4,0,38,0,,0,,,0,,,,,,
20200309,NJ,46,9,11,5,35,4,,0,,,0,,,,,,
20200309,NM,57,9,0,0,57,9,,0,,,0,,,,,,
20200309,NV,15,0,1,0,14,0,0,0,,,0,,,,,,
20200309,NY,234,37,142,37,92,0,,0,,,0,,,,,,
20200309,OH,14,4,3,3,11,1,,0,,,0,,,,,,
20200309,OK,9,0,1,0,8,0,,0,,,0,,,,,,
20200309,OR,179,65,14,0,165,65,,0,,,0,,,,,,
20200309,PA,10,4,10,4,,0,,0,,,0,,,,,,
20200309,RI,86,16,4,1,82,15,,0,,,0,,,,,,
20200309,SC,31,21,7,5,24,16,,0,,,0,,,,,,
20200309,SD,5,0,0,0,5,0,,0,,,0,,,,,,
20200309,TN,3,0,3,0,,0,,0,,,0,,,,,,
20200309,TX,12,4,12,4,,0,,0,,,0,,,,,,
20200309,UT,1,0,1,0,,0,,0,,,0,,,,,,
20200309,VA,41,3,3,1,38,2,,0,,,0,,,,,,
20200309,VT,37,6,1,0,36,6,,0,,,0,,,,,,
20200309,WA,3829,1024,1237,172,2592,852,35,4,,,0,,,,,,
20200309,WI,37,5,1,0,36,5,,0,,,0,,,,,,
20200309,WV,2,0,0,0,2,0,,0,,,0,,,,,,
20200309,WY,0,0,0,0,,0,,0,,,0,,,,,,
20200308,AK,14,2,0,0,14,2,0,0,,,0,,,,,,
20200308,AL,0,0,0,0,,0,,0,,,0,,,,,,
20200308,AR,6,0,0,0,6,0,,0,,,0,,,,,,
20200308,AZ,49,0,5,0,44,0,,0,6,,0,,,,,,
20200308,CA,550,19,88,19,462,0,,0,,,0,,,,,,
20200308,CO,112,49,8,0,104,49,,0,,,0,,,,,,
20200308,CT,30,30,1,1,29,29,,0,,,0,,,,,,
20200308,DC,11,3,1,1,10,2,,0,,,0,,,,,,
20200308,DE,10,0,0,0,10,0,0,0,,,0,,,,,,
20200308,FL,135,21,17,3,118,18,,0,,,0,,,,,,
20200308,GA,7,1,7,1,,0,,0,,,0,,,,,,
20200308,HI,1,0,1,0,,0,,0,,,0,,,,,,
20200308,IA,15,0,0,0,15,0,,0,,,0,,,,,,
20200308,ID,27,0,0,0,27,0,,0,,,0,,,,,,
20200308,IL,197,0,6,0,191,0,,0,,,0,,,,,,
20200308,IN,2,1,2,1,,0,,0,,,0,,,,,,
20200308,KS,12,1,1,1,11,0,,0,,,0,,,,,,
20200308,KY,14,4,1,0,13,4,,0,,,0,,,,,,
20200308,LA,5,5,0,0,5,5,,0,,,0,,,,,,
20200308,MD,55,11,3,0,52,11,,0,,,0,,,,,,
20200308,ME,1,0,0,0,1,0,,0,,,0,,,,,,
20200308,MI,194,48,168,40,26,8,,0,,,0,,,,,,
20200308,MN,50,0,2,0,48,0,,0,,,0,,,,,,
20200308,MO,1,1,1,1,,0,,0,,,0,,,,,,
20200308,MS,0,0,0,0,,0,,0,,,0,,,,,,
20200308,MT,11,0,0,0,11,0,,0,,,0,,,,,,
20200308,NC,2,0,2,0,,0,,0,,,0,,,,,,
20200308,ND,0,0,0,0,0,0,,0,,,0,,,,,,
20200308,NE,18,0,1,0,17,0,,0,,,0,,,,,,
20200308,NH,42,20,4,2,38,18,,0,,,0,,,,,,
20200308,NJ,37,33,6,2,31,31,,0,,,0,,,,,,
20200308,NM,48,0,0,0,48,0,,0,,,0,,,,,,
20200308,NV,15,0,1,0,14,0,0,0,,,0,,,,,,
20200308,NY,197,29,105,29,92,0,,0,,,0,,,,,,
20200308,OH,10,1,0,0,10,1,,0,,,0,,,,,,
20200308,OK,9,8,1,0,8,8,,0,,,0,,,,,,
20200308,OR,114,30,14,7,100,23,,0,,,0,,,,,,
20200308,PA,6,2,6,2,,0,,0,,,0,,,,,,
20200308,RI,70,18,3,0,67,18,,0,,,0,,,,,,
20200308,SC,10,0,2,0,8,0,,0,,,0,,,,,,
20200308,SD,5,0,0,0,5,0,,0,,,0,,,,,,
20200308,TN,3,2,3,2,,0,,0,,,0,,,,,,
20200308,TX,8,0,8,0,,0,,0,,,0,,,,,,
20200308,UT,1,0,1,0,,0,,0,,,0,,,,,,
20200308,VA,38,7,2,2,36,5,,0,,,0,,,,,,
20200308,VT,31,5,1,0,30,5,,0,,,0,,,,,,
20200308,WA,2805,523,1065,153,1740,370,31,4,,,0,,,,,,
20200308,WI,32,0,1,0,31,0,,0,,,0,,,,,,
20200308,WV,2,0,0,0,2,0,,0,,,0,,,,,,
20200308,WY,0,0,0,0,,0,,0,,,0,,,,,,
20200307,AK,12,4,0,0,12,4,0,0,,,0,,,,,,
20200307,AL,0,0,0,0,,0,,0,,,0,,,,,,
20200307,AR,6,0,0,0,6,0,,0,,,0,,,,,,
20200307,AZ,49,13,5,2,44,11,,0,6,,0,,,,,,
20200307,CA,531,9,69,9,462,0,,0,,,0,,,,,,
20200307,CO,63,15,8,6,55,9,,0,,,0,,,,,,
20200307,CT,0,0,0,0,,0,,0,,,0,,,,,,
20200307,DC,8,0,0,0,8,0,,0,,,0,,,,,,
20200307,DE,10,0,0,0,10,0,,0,,,0,,,,,,
20200307,FL,114,50,14,5,100,45,,0,,,0,,,,,,
20200307,GA,6,4,6,4,,0,,0,,,0,,,,,,
20200307,HI,1,0,1,0,,0,,0,,,0,,,,,,
20200307,IA,15,0,0,0,15,0,,0,,,0,,,,,,
20200307,ID,27,0,0,0,27,0,,0,,,0,,,,,,
20200307,IL,197,12,6,1,191,11,,0,,,0,,,,,,
20200307,IN,1,0,1,0,,0,,0,,,0,,,,,,
20200307,KS,11,7,0,0,11,7,,0,,,0,,,,,,
20200307,KY,10,3,1,1,9,2,,0,,,0,,,,,,
20200307,LA,0,0,0,0,,0,,0,,,0,,,,,,
20200307,MD,44,15,3,0,41,15,,0,,,0,,,,,,
20200307,ME,1,0,0,0,1,0,,0,,,0,,,,,,
20200307,MI,146,40,128,30,18,10,,0,,,0,,,,,,
20200307,MN,50,13,2,1,48,12,,0,,,0,,,,,,
20200307,MO,0,0,0,0,,0,,0,,,0,,,,,,
20200307,MS,0,0,0,0,,0,,0,,,0,,,,,,
20200307,MT,11,0,0,0,11,0,,0,,,0,,,,,,
20200307,NC,2,0,2,0,,0,,0,,,0,,,,,,
20200307,ND,0,0,0,0,0,0,,0,,,0,,,,,,
20200307,NE,18,1,1,1,17,0,,0,,,0,,,,,,
20200307,NH,22,0,2,0,20,0,,0,,,0,,,,,,
20200307,NJ,4,3,4,3,,0,,0,,,0,,,,,,
20200307,NM,48,32,0,0,48,32,,0,,,0,,,,,,
20200307,NV,15,0,1,0,14,0,0,0,,,0,,,,,,
20200307,NY,168,43,76,43,92,0,,0,,,0,,,,,,
20200307,OH,9,1,0,0,9,1,,0,,,0,,,,,,
20200307,OK,1,0,1,0,,0,,0,,,0,,,,,,
20200307,OR,84,17,7,4,77,13,,0,,,0,,,,,,
20200307,PA,4,2,4,2,,0,,0,,,0,,,,,,
20200307,RI,52,19,3,0,49,19,,0,,,0,,,,,,
20200307,SC,10,5,2,2,8,3,,0,,,0,,,,,,
20200307,SD,5,0,0,0,5,0,,0,,,0,,,,,,
20200307,TN,1,0,1,0,,0,,0,,,0,,,,,,
20200307,TX,8,3,8,3,,0,,0,,,0,,,,,,
20200307,UT,1,0,1,0,,0,,0,,,0,,,,,,
20200307,VA,31,10,0,0,31,10,,0,,,0,,,,,,
20200307,VT,26,26,1,1,25,25,,0,,,0,,,,,,
20200307,WA,2282,403,912,99,1370,304,27,1,,,0,,,,,,
20200307,WI,32,0,1,0,31,0,,0,,,0,,,,,,
20200307,WV,2,1,0,0,2,1,,0,,,0,,,,,,
20200307,WY,0,0,0,0,,0,,0,,,0,,,,,,
20200306,AK,8,0,0,0,8,0,0,0,,,0,,,,,,
20200306,AR,6,0,0,0,6,0,,0,,,0,,,,,,
20200306,AZ,36,6,3,1,33,5,,0,6,,1,,,,,,
20200306,CA,522,7,60,7,462,0,,0,,,0,,,,,,
20200306,CO,48,29,2,2,46,27,,0,,,0,,,,,,
20200306,DC,8,2,0,0,8,2,,0,,,0,,,,,,
20200306,DE,10,0,0,0,10,0,,0,,,0,,,,,,
20200306,FL,64,24,9,0,55,24,,0,,,0,,,,,,
20200306,GA,2,0,2,0,,0,,0,,,0,,,,,,
20200306,IA,15,0,0,0,15,0,,0,,,0,,,,,,
20200306,IL,185,15,5,0,180,15,,0,,,0,,,,,,
20200306,IN,1,0,1,0,,0,,0,,,0,,,,,,
20200306,KS,4,0,0,0,4,0,,0,,,0,,,,,,
20200306,KY,7,0,0,0,7,0,,0,,,0,,,,,,
20200306,MD,29,12,3,3,26,9,,0,,,0,,,,,,
20200306,MI,106,26,98,26,8,0,,0,,,0,,,,,,
20200306,MN,37,0,1,0,36,0,,0,,,0,,,,,,
20200306,NC,2,1,2,1,,0,,0,,,0,,,,,,
20200306,NE,17,0,0,0,17,0,,0,,,0,,,,,,
20200306,NH,22,4,2,0,20,4,,0,,,0,,,,,,
20200306,NJ,1,0,1,0,,0,,0,,,0,,,,,,
20200306,NM,16,0,0,0,16,0,,0,,,0,,,,,,
20200306,NV,15,0,1,0,14,0,0,0,,,0,,,,,,
20200306,NY,125,27,33,11,92,16,,0,,,0,,,,,,
20200306,OH,8,1,0,0,8,1,,0,,,0,,,,,,
20200306,OR,67,19,3,0,64,19,,0,,,0,,,,,,
20200306,PA,2,0,2,0,,0,,0,,,0,,,,,,
20200306,RI,33,11,3,0,30,11,,0,,,0,,,,,,
20200306,SC,5,0,0,0,5,0,,0,,,0,,,,,,
20200306,TN,1,0,1,0,,0,,0,,,0,,,,,,
20200306,TX,5,4,5,4,,0,,0,,,0,,,,,,
20200306,VA,21,3,0,0,21,3,,0,,,0,,,,,,
20200306,VT,0,0,0,0,0,0,,0,,,0,,,,,,
20200306,WA,1879,476,813,82,1066,394,26,6,,,0,,,,,,
20200306,WI,32,12,1,0,31,12,,0,,,0,,,,,,
20200306,WV,1,0,0,0,1,0,,0,,,0,,,,,,
20200305,AZ,30,1,2,0,28,1,,0,5,,1,,,,,,
20200305,CA,515,0,53,0,462,0,,0,,,0,,,,,,
20200305,CO,19,0,0,0,19,0,,0,,,0,,,,,,
20200305,DC,6,0,0,0,6,0,,0,,,0,,,,,,
20200305,FL,40,14,9,7,31,7,,0,,,0,,,,,,
20200305,GA,2,0,2,0,,0,,0,,,0,,,,,,
20200305,IL,170,42,5,1,165,41,,0,,,0,,,,,,
20200305,MD,17,0,0,0,17,0,,0,,,0,,,,,,
20200305,MI,80,28,72,20,8,8,,0,,,0,,,,,,
20200305,NC,1,0,1,0,,0,,0,,,0,,,,,,
20200305,NE,17,0,0,0,17,0,,0,,,0,,,,,,
20200305,NH,18,6,2,0,16,6,,0,,,0,,,,,,
20200305,NJ,1,0,1,0,,0,,0,,,0,,,,,,
20200305,NV,15,0,1,0,14,0,0,0,,,0,,,,,,
20200305,NY,98,44,22,16,76,28,,0,,,0,,,,,,
20200305,OH,7,0,0,0,7,0,,0,,,0,,,,,,
20200305,OR,48,16,3,0,45,16,,0,,,0,,,,,,
20200305,RI,22,5,3,1,19,4,,0,,,0,,,,,,
20200305,SC,5,0,0,0,5,0,,0,,,0,,,,,,
20200305,TN,1,0,1,0,,0,,0,,,0,,,,,,
20200305,TX,1,0,1,0,,0,,0,,,0,,,,,,
20200305,VA,18,0,0,0,18,0,,0,,,0,,,,,,
20200305,WA,1403,360,731,105,672,255,20,4,,,0,,,,,,
20200305,WI,20,0,1,0,19,0,,0,,,0,,,,,,
20200304,AZ,29,0,2,0,27,0,,0,4,,0,,,,,,
20200304,CA,515,0,53,0,462,0,,0,,,0,,,,,,
20200304,FL,26,0,2,0,24,0,,0,,,0,,,,,,
20200304,GA,2,0,2,0,,0,,0,,,0,,,,,,
20200304,IL,128,0,4,0,124,0,,0,,,0,,,,,,
20200304,MI,52,18,52,18,,0,,0,,,0,,,,,,
20200304,NC,1,0,1,0,,0,,0,,,0,,,,,,
20200304,NH,12,0,2,0,10,0,,0,,,0,,,,,,
20200304,NY,54,0,6,0,48,0,,0,,,0,,,,,,
20200304,OR,32,0,3,0,29,0,,0,,,0,,,,,,
20200304,RI,17,10,2,0,15,10,,0,,,0,,,,,,
20200304,SC,5,0,0,0,5,0,,0,,,0,,,,,,
20200304,TX,1,0,1,0,,0,,0,,,0,,,,,,
20200304,WA,1043,245,626,92,417,153,16,2,,,0,,,,,,
20200304,WI,20,0,1,0,19,0,,0,,,0,,,,,,
20200303,MI,34,16,34,16,,0,,0,,,0,,,,,,
20200303,RI,7,2,2,0,5,2,,0,,,0,,,,,,
20200303,WA,798,225,534,84,264,141,14,3,,,0,,,,,,
20200302,MI,18,9,18,9,,0,,0,,,0,,,,,,
20200302,RI,5,1,2,0,3,1,,0,,,0,,,,,,
20200302,WA,573,184,450,73,123,111,11,3,,,0,,,,,,
20200301,MI,9,0,9,0,,0,,0,,,0,,,,,,
20200301,RI,4,0,2,0,2,0,,0,,,0,,,,,,
20200301,WA,389,73,377,78,12,-5,8,3,,,0,,,,,,
20200229,WA,316,41,299,24,17,17,5,1,,,0,,,,,,
20200228,WA,275,40,275,40,0,0,4,2,,,0,,,,,,
20200227,WA,235,27,235,27,0,0,2,0,,,0,,,,,,
20200226,WA,208,29,208,29,0,0,2,2,,,0,,,,,,
20200225,WA,179,31,179,31,0,0,,0,,,0,,,,,,
20200224,WA,148,26,148,26,0,0,,0,,,0,,,,,,
20200223,WA,122,16,122,16,0,0,,0,,,0,,,,,,
20200222,WA,106,13,106,13,0,0,,0,,,0,,,,,,
20200221,WA,93,11,93,11,0,0,,0,,,0,,,,,,
20200220,WA,82,13,82,13,0,0,,0,,,0,,,,,,
20200219,WA,69,10,69,10,0,0,,0,,,0,,,,,,
20200218,WA,59,9,59,9,0,0,,0,,,0,,,,,,
20200217,WA,50,15,50,15,0,0,,0,,,0,,,,,,
20200216,WA,35,7,35,7,0,0,,0,,,0,,,,,,
20200215,WA,28,7,28,7,0,0,,0,,,0,,,,,,
20200214,WA,21,3,21,3,0,0,,0,,,0,,,,,,
20200213,WA,18,0,18,0,0,0,,0,,,0,,,,,,
20200212,WA,18,1,18,1,0,0,,0,,,0,,,,,,
20200211,WA,17,1,17,1,0,0,,0,,,0,,,,,,
20200210,WA,16,3,16,3,0,0,,0,,,0,,,,,,
20200209,WA,13,0,13,0,0,0,,0,,,0,,,,,,
20200208,WA,13,1,13,1,0,0,,0,,,0,,,,,,
20200207,WA,12,1,12,1,0,0,,0,,,0,,,,,,
20200206,WA,11,3,11,3,0,0,,0,,,0,,,,,,
20200205,WA,8,0,8,0,0,0,,0,,,0,,,,,,
20200204,WA,8,1,8,1,0,0,,0,,,0,,,,,,
20200203,WA,7,1,7,1,0,0,,0,,,0,,,,,,
20200202,WA,6,2,6,2,0,0,,0,,,0,,,,,,
20200201,WA,4,1,4,1,0,0,,0,,,0,,,,,,
20200131,WA,3,0,3,0,0,0,,0,,,0,,,,,,
20200130,WA,3,0,3,0,0,0,,0,,,0,,,,,,
20200129,WA,3,1,3,1,0,0,,0,,,0,,,,,,
20200128,WA,2,0,2,0,0,0,,0,,,0,,,,,,
20200127,WA,2,0,2,0,0,0,,0,,,0,,,,,,
20200126,WA,2,0,2,0,0,0,,0,,,0,,,,,,
20200125,WA,2,0,2,0,0,0,,0,,,0,,,,,,
20200124,WA,2,0,2,0,0,0,,0,,,0,,,,,,
20200123,WA,2,0,2,0,0,0,,0,,,0,,,,,,
20200122,WA,2,0,2,0,0,0,,0,,,0,,,,,,
